a=一个
abandon=放弃
abase=卑贱
abash=惊讶
abashed=羞愧
abate=减弱
abbreviate=缩写
abbreviation=缩写
abdicate=放弃
abduct=拐
aberrant=异常
aberration=像差
abet=助长
abeyance=暂缓
abhor=痛恨
abhorrent=令人憎恶
abide=遵守
ability=能力
abject=卑贱的
abjure=放弃
ablaze=燃烧
able=有能力的
ablution=沐浴
abnegate=舍弃
abnegation=放弃
abnormal=异常
aboard=船上
abolish=取消
abolition=废除
abominate=鄙弃
aboriginal=土著
abort=中止
abortion=流产
abortive=未遂
abound=盛产
about=关于
above=多于
aboveboard=光明正大
abrade=研磨
abrasion=磨损
abrasive=磨料
abreast=并肩
abridge=删节
abroad=国外
abrogate=废除
abrupt=突然
abscission=脱落
abscond=潜逃
absence=缺席
absent=缺席的
absenteeism=旷工
absolute=绝对
absolutely=绝对地
absolve=开脱
absorb=吸收
absorbing=吸收
absorption=吸收
abstain=弃权
abstemious=节制的
abstention=弃权
abstentious=节制的
abstinence=节制
abstinent=禁欲
abstract=抽象的
abstraction=抽象
abstruse=奥
absurd=荒诞
absurdity=荒诞
abundance=丰富
abundant=丰富
abuse=虐待
abusive=辱骂
abut=邻接
abysmal=糟糕透顶
academic=学术的
academician=院士
academy=学院
acarpous=无果
accede=同意
accelerate=加速
acceleration=加速度
accent=口音
accentuate=强调
accept=接受
acceptable=可接受
acceptance=验收
access=使用权
accessible=无障碍
accessory=配饰
accident=事故
accidental=偶然
acclaim=欢呼
acclimate=适应
accolade=荣誉
accommodate=容纳
accommodating=包容
accommodation=住宿
accompany=陪伴
accomplice=同案犯
accomplish=完成
accomplished=完成
accomplishment=成就
accord=符合
accordance=依照
according to=根据
accordingly=因此
accost=招呼
account=帐户
accountability=问责制
accountable=可负责
accountancy=会计
accountant=会计
accounting=会计
accrete=增生
accretion=吸积
accrue=累积
accumulate=积累
accumulation=积累
accumulative=累计
accuracy=准确性
accurate=准确的
accusation=指控
accuse=控
accustom=习惯
accustomed=习惯了
ace=高手
acerbic=尖酸的
acerbity=酸涩
ache=疼痛
achieve=达到
achievement=成就
achromatic=消色差
acid=酸
acidity=酸度
acknowledge=承认
acknowledgement=致谢
acme=巅峰
acolyte=侍僧
acorn=橡子
acoustic=声学
acquaint=熟悉
acquaintance=熟人
acquainted=熟悉
acquiesce=默许
acquire=获得
acquired=获得
acquisition=获得
acquisitive=贪得无厌
acquit=开释
acquittal=开释
acre=英亩
acrid=辛辣
acrimonious=尖刻
acrimony=尖刻的言辞
acrobat=杂技演员
acronym=缩写
acrophobia=恐高症
across=穿过
act=行为
acting=演技
action=行动
activate=激活
active=积极的
activist=活动家
activity=活动
actor=演员
actress=演员
actual=实际的
actually=实际上
actuarial=精算
actuate=启动
acuity=敏锐度
acumen=敏锐
acupuncture=针刺
acute=急性
ad=广告
adage=谚语
adamant=固执的
adapt=适应
adaptable=适应性
adaptation=适应
adaptive=自适应
add=添加
addendum=附录
addict=瘾君子
addicted=上瘾
addiction=瘾
addictive=令人上瘾
addition=添加
additional=额外的
additive=添加剂
addle=糊涂
address=地址
adduce=引证
adept=熟练
adequacy=充足性
adequate=足够的
adequately=充分
adhere=坚持
adherence=坚持
adherent=追随者
adhesive=粘合剂
adjacent=邻近的
adjective=形容词
adjoin=毗
adjoining=毗连
adjourn=休会
adjudicate=裁定
adjunct=附件
adjust=调整
adjustment=调整
adlib=即兴发挥
administer=管理
administrate=管理
administration=行政
administrative=行政
admirable=令人钦佩
admiration=钦佩
admire=钦佩
admission=入场
admit=承认
admittance=准入
admittedly=无可否认
admonish=谏
adobe=土坯
adolescence=青春期
adolescent=青少年
adopt=采纳
adoption=采用
adorable=可爱的
adore=崇拜
adorn=装饰
adroit=熟练的
adulate=谄媚
adult=成人
adulterate=掺杂
adulthood=成年
adumbrate=预示
advance=进步
advanced=先进的
advancement=进步
advantage=优势
advantageous=有利
advent=来临
adventitious=不定
adventure=冒险
adventurer=冒险家
adventurous=冒险
adverb=副词
adversary=对手
adverse=不利的
adversity=逆境
advert=广告
advertise=广告
advertisement=广告
advertising=广告
advice=建议
advisable=可取的
advise=建议
adviser=顾问
advisor=顾问
advisory=咨询
advocacy=倡导
advocate=提倡
aegis=宙斯盾
aerate=通气
aerial=天线
aerobic=有氧
aeronautics=航空学
aeroplane=飞机
aesthete=唯美主义者
aesthetic=审美的
aesthetics=美学
affable=和蔼可亲
affair=事务
affect=影响
affectation=做作
affected=做作的
affection=感情
affectionate=亲热
affidavit=宣誓书
affiliate=附属机构
affiliation=联系
affinity=亲和力
affirm=确认
affirmation=肯定
affirmative=肯定
affix=词缀
affixation=附加
afflict=折磨
afflicting=折磨
affliction=痛苦
affluence=富裕
affluent=富裕
afford=买得起
affordability=负担能力
affordable=负担得起
affront=冒犯
afloat=漂浮
afraid=害怕的
after=后
aftermath=后果
afternoon=下午
afterward=之后
afterwards=然后
again=再次
against=反对
agape=爱
age=年龄
aged=年龄
ageing=老化
agency=机构
agenda=议程
agent=代理人
agglomerate=凝聚
aggrandize=夸大
aggravate=加剧
aggravation=加重
aggregate=总计的
aggression=侵略
aggressive=挑衅的
aggressor=侵略者
aggrieve=侵害
aghast=惊骇
agile=敏捷
agility=敏捷
aging=老化
agitate=激荡
agitated=激动
agitation=搅动
agnostic=不可知论者
ago=前
agog=兴奋
agonize=烦恼
agony=痛苦
agrarian=农业的
agree=同意
agreeable=令人愉快的
agreement=协议
agricultural=农业
agriculture=农业
agronomy=农艺学
ahead=前方
aid=援助
aide=助手
aids=艾滋病
ail=艾尔
ailment=病痛
aim=目的
air=空气
air-conditioner=空调
air-conditioning=空调
airborne=空中
aircraft=飞机
airline=航空公司
airplane=飞机
airport=飞机场
airtight=密闭
aisle=走道
akin=类似的
alabaster=雪花石膏
alacrity=敏捷
alarm=警报
albeit=尽管
albino=白化病
album=专辑
alchemist=鍊金術士
alchemy=炼金术
alcohol=酒精
alcoholic=酒鬼
alcove=壁龛
ale=麦酒
alert=警报
alga=藻类
algebra=代数
alias=别名
alibi=不在场证明
alien=外星人
alienate=离间
alienation=异化
align=对齐
alignment=结盟
alike=相似
alimentary=食物的
alive=活
alkali=碱
all=全部
allay=缓和
allegation=指控
allege=指控
alleged=据称
allegedly=据称
allegiance=忠诚
allegory=寓言
allergic=过敏
allergy=过敏
alleviate=减轻
alleviation=缓解
alley=胡同
alliance=联盟
alliterate=头韵
allocate=分配
allocation=分配
allot=分配
allotment=分配
allow=允许
allowance=津贴
alloy=合金
allude=暗示
allure=引诱
allurement=诱惑
alluring=诱人的
allusion=典故
ally=盟友
almighty=全能的
almond=杏仁
almost=几乎
alms=施舍
aloft=在高处
alone=独自的
along=沿着
alongside=旁边
aloof=超然
aloud=大声地
alphabet=字母
alphabetic=字母的
alphabetical=按字母顺序
already=已经
also=还
alter=改变
alteration=改造
alternate=备用
alternately=交替
alternation=交替
alternative=选择
although=虽然
altitude=高度
altogether=共
altruism=利他主义
altruistic=利他主义
aluminium=铝
aluminum=铝
alumnus=校友
always=总是
am=是
amalgam=汞合金
amalgamate=合并
amass=聚集
amateur=业余
amateurish=业余的
amaze=惊奇
amazed=惊讶
amazement=惊愕
amazing=惊人的
ambassador=大使
ambidextrous=双手灵巧
ambience=环境
ambiguity=歧义
ambiguous=模糊的
ambition=志向
ambitious=雄心勃勃
ambivalence=矛盾心理
ambivalent=矛盾的
amble=缓行
ambrosial=美味可口的
ambulance=救护车
ambulatory=门诊
ambush=伏击
ameliorate=改善
amenable=顺从
amend=修正
amendment=修正案
amenity=便利设施
amethyst=紫晶
amiable=可亲
amicable=友善
amid=之中
amidst=其中
amino=氨基
amiss=不妥
amity=和睦
ammonia=氨
ammunition=弹药
amnesia=健忘症
amnesty=大赦
among=之中
amongst=之中
amoral=不道德的
amorphous=非晶态
amortize=缓冲
amount=数量
amphibian=两栖动物
ample=充足
amplification=放大
amplify=放大
amplitude=振幅
amputate=截肢
amulet=护身符
amuse=娱乐
amusement=娱乐
amusing=有趣
an=一个
anachronistic=不合时宜
anaerobic=厌氧
anagram=字谜
analgesia=镇痛
analgesic=止痛药
analogous=类似的
analogue=类似物
analogy=类比
analyse=分析
analysis=分析
analyst=分析师
analytic=分析
analytical=分析
analyze=分析
anarchist=无政府主义者
anarchy=无政府状态
anathema=诅咒
anatomical=解剖的
anatomy=解剖学
ancestor=祖先
ancestry=祖先
anchor=锚
anchorage=锚地
ancient=古老的
ancillary=附属的
and=和
anecdotal=轶事
anecdote=轶事
anemia=贫血
anemic=贫血
anesthetic=麻药
anew=重新
angel=天使
anger=愤怒
angle=角度
angry=生气的
anguish=痛苦
angular=角度
anhydrous=无水
animadvert=批评
animal=动物
animate=动画
animated=动画
animation=动画片
animosity=敌意
animus=敌意
ankle=踝
annals=志
annex=附件
annexation=吞并
annihilate=歼灭
anniversary=周年纪念日
annotate=注释
announce=宣布
announcement=公告
annoy=惹恼
annoyance=烦恼
annoyed=恼火
annual=年度的
annually=每年
annul=废止
anodyne=止痛药
anomalous=异常的
anomaly=异常
anonymity=匿名
anonymous=匿名的
anorexia=厌食症
another=其他
answer=回答
ant=蚂蚁
antagonism=对抗
antagonist=拮抗剂
antagonistic=对抗性的
antagonistically=对抗地
antagonize=对抗
antarctic=南极
antecedence=先行
antecedent=先行
antedate=早于
antediluvian=洪水之前的
antenna=天线
anterior=前部
anthem=国歌
anthology=选集
anthropoid=类人猿
anthropologist=人类学家
anthropology=人类学
antibiotic=抗生素
antibody=抗体
antic=滑稽
anticipate=预料
anticipation=预期
anticipatory=预期的
anticlimax=虎头蛇尾
antidote=解毒剂
antihistamine=抗组胺药
antipathy=反感
antiquated=过时的
antique=古董
antiquity=古代
antiseptic=防腐剂
antithesis=对立
antonym=反义词
anvil=砧
anxiety=焦虑
anxious=焦虑的
any=任何
anybody=任何人
anyhow=无论如何
anyone=任何人
anything=任何事物
anyway=反正
anywhere=任何地方
aorta=主动脉
apart=分开
apartment=公寓
apathetic=冷漠的
ape=猿
aperture=光圈
apex=顶点
aphorism=格言
apiary=蜂房
aplomb=泰然自若
apocalyptic=启示录
apocrypha=伪经
apocryphal=伪经
apogee=远地点
apologetic=表示歉意
apologise=道歉
apologize=道歉
apology=道歉
apoplectic=中风的
apostasy=叛教
apostate=叛教者
apostrophe=撇号
apothecary=药剂师
apothegm=箴言
apotheosis=神化
app=应用程序
appal=惊骇
appall=惊恐
appalling=骇人听闻
apparatus=设备
apparel=服饰
apparent=明显的
apparently=显然
apparition=幻影
appeal=上诉
appealing=有吸引力
appear=出现
appearance=外貌
appease=安抚
appeasement=绥靖
appellation=称谓
appendage=附属物
appendix=附录
appetite=食欲
appetizer=开胃菜
appetizing=开胃
applaud=鼓掌
applause=掌声
apple=苹果
appliance=器具
applicable=适用的
applicant=申请人
application=应用
apply=申请
appoint=委
appointment=预约
apposite=适当
appraisal=评价
appraise=评价
appreciable=可观的
appreciate=欣赏
appreciation=欣赏
appreciative=赞赏的
apprehend=逮捕
apprehension=忧虑
apprehensive=忧虑
apprentice=学徒
apprise=通知
approach=方法
approbation=赞许
appropriate=合适的
appropriation=拨款
approval=赞同
approve=批准
approximate=近似
approximately=大约
approximation=近似
april=四月
apron=围裙
apropos=顺便提一下
apt=易于
aptitude=资质
aptly=恰当地
aquarium=水族馆
aquatic=水
aqueduct=渡槽
aquifer=含水层
aquiline=鹰钩鼻
arabesque=蔓藤花纹
arable=可耕地
arachnid=蛛形纲
arbiter=仲裁者
arbitrarily=任意地
arbitrary=随意的
arbitrate=仲裁
arbitration=仲裁
arbitrator=仲裁人
arboreal=树栖的
arboretum=植物园
arc=弧
arcane=神秘的
arch=拱
archaeology=考古学
archaic=古风
archer=射手
archetype=原型
archipelago=群岛
architect=建筑师
architecture=建筑学
archive=档案
arctic=北极
ardent=热心
ardor=热情
arduous=艰巨
area=区域
arena=竞技场
argot=隐语
arguable=有争议的
argue=争论
argument=争论
argumentation=论证
argumentative=议论性的
aria=咏叹调
arid=干旱
arise=出现
aristocracy=贵族
aristocrat=贵族
aristocratic=贵族的
arithmetic=算术
arm=手臂
armada=舰队
armament=武器
armistice=停战
armor=盔甲
armory=军械库
armour=盔甲
army=军队
aroma=香气
aromatic=芳香
around=大约
arousal=唤醒
arouse=引起
arraign=提审
arrange=安排
arrangement=安排
arrant=犯有
array=大批
arrest=逮捕
arresting=引人注目
arrhythmic=心律失常
arrival=到达
arrive=到达
arrogance=傲慢
arrogant=傲慢的
arrogate=擅自
arrow=箭
arroyo=阿罗约
arsenal=兵工厂
arson=纵火
art=艺术
artery=动脉
arthritis=关节炎
article=文章
articulate=表达能力
articulation=关节
artifact=人工制品
artifacts=文物
artifice=技巧
artificial=人造的
artillery=炮兵
artisan=工匠
artist=艺术家
artistic=艺术的
artistically=艺术地
artistry=艺术性
artless=朴实无华
as=作为
ascend=上升
ascendance=上升
ascendancy=优势
ascending=上升
ascent=上升
ascertain=探明
ascetic=苦行者
ascribe=归咎于
aseptic=无菌
ash=灰
ashamed=羞愧
ashore=岸上
aside=一边
asinine=愚蠢
ask=问
askance=斜眼
askew=歪斜
asleep=睡着了
asparagus=芦笋
aspect=方面
aspen=阿斯彭
asperity=粗糙
asperse=洒水
aspersion=诽谤
asphalt=沥青
asphyxia=窒息
asphyxiate=窒息
aspirant=有志者
aspiration=愿望
aspire=渴望
ass=屁股
assail=攻击
assassin=刺客
assassinate=暗杀
assassination=暗杀
assault=突击
assay=测定
assemble=集合
assembly=集会
assent=同意
assert=断言
assertion=断言
assertive=自信
assertiveness=自信
assess=评估
assessment=评估
asset=资产
assiduous=刻苦
assign=分配
assignment=任务
assimilate=吸收
assimilation=同化
assist=协助
assistance=协助
assistant=助手
associate=联系
association=协会
assoil=土壤
assorted=什锦
assortment=品种
assuage=缓和
assume=认为
assumption=假设
assurance=保证
assure=保证
assured=保证
asterisk=星号
asteroid=小行星
asthma=哮喘
astigmatic=散光
astonish=震惊
astonished=惊讶
astonishment=惊讶
astound=震惊
astray=误入歧途
astringent=涩
astrolabe=星盘
astrology=占星术
astronaut=宇航员
astronomer=天文学家
astronomical=天文
astronomy=天文学
astute=精明
asunder=分裂
asylum=庇护
asymmetric=不对称
at=在
atheism=无神论
athlete=运动员
athletic=运动
athletics=竞技
atlas=阿特拉斯
atmosphere=气氛
atmospheric=大气
atom=原子
atomic=原子
atonal=无调性的
atone=赎罪
atop=位于顶部
atrocious=残暴
atrocity=暴行
atrophy=萎缩
attach=附
attachment=依恋
attack=攻击
attain=达到
attainment=素养
attempt=试图
attend=出席
attendance=出席
attendant=服务员
attention=注意力
attentive=细心
attenuate=衰减
attest=证明
attic=阁楼
attire=服装
attitude=态度
attorney=律师
attract=吸引
attraction=景点
attractive=吸引人的
attributable=归因于
attribute=属性
attributive=定语
attrition=减员
attune=调和
auction=拍卖
auctioneer=拍卖
audacious=大胆的
audible=听得见的
audience=观众
audio=声音的
audit=审计
auditing=审计
audition=试镜
auditor=审计员
auditorium=礼堂
auger=螺旋钻
augment=增强
augmentation=增强
augur=占卜者
augury=占卜
august=八月
aunt=阿姨
auntie=阿姨
aura=光环
aureole=光环
auricular=耳廓
auspice=前兆
auspices=主持
auspicious=吉祥
austere=简朴
austerity=紧缩政策
authentic=真正的
authenticity=真实性
author=作者
authorisation=授权
authorise=授权
authoritarian=威权主义
authoritative=权威性
authority=权威
authorization=授权
authorize=授权
auto=汽车
autobiographic=自传
autobiographical=自传
autobiography=自传
autocracy=专制
autocrat=独裁者
automate=自动化
automatic=自动的
automatically=自动地
automation=自动化
automobile=汽车
autonomous=自主
autonomy=自治
autumn=秋天
auxiliary=辅助的
avail=可用
availability=可用性
available=可用的
avalanche=雪崩
avant-garde=前卫
avarice=贪婪
avaricious=贪婪
avenge=报仇
avenue=大街
aver=断言
average=平均的
averse=厌恶
aversion=厌恶
avert=避免
aviary=鸟舍
aviation=航空
aviator=飞行员
avid=热衷于
avocation=爱好
avoid=避免
avoidance=回避
avow=承认
avowal=承认
avuncular=慈祥的
await=等待
awake=醒
award=奖
aware=意识到的
awareness=意识
away=离开
awe=敬畏
awe-inspiring=令人敬畏
awesome=惊人的
awful=可怕
awkward=尴尬的
awl=锥子
awning=棚
awry=出差错
ax=斧头
axe=斧头
axiom=公理
axis=轴
axle=轴
azure=天蓝色
babble=潺潺
baby=婴儿
baby-sit=照看孩子
babyboom=婴儿潮
babyboomer=婴儿潮一代
babylonian=巴比伦
bacchanal=狂欢
bachelor=学士
back=后退
backdrop=背景
background=背景
backhanded=反手
backlighting=背光
backset=涡流
backslide=倒退
backup=备份
backward=落后
backwards=向后
backwater=回水
backyard=后院
bacon=熏肉
bacteria=细菌
bacterium=细菌
bad=坏的
badge=徽章
badger=獾
badinage=调侃
badly=糟糕地
badminton=羽毛球
baffle=挡板
bag=包
baggage=行李
bail=保释
bait=饵
bake=烤
bakery=面包店
balance=平衡
balcony=阳台
bald=秃
bale=包
baleful=恶毒的
balk=拒绝
balky=不听话
ball=球
ballad=民谣
ballast=压载物
ballerina=芭蕾舞女演员
ballet=芭蕾舞
balloon=气球
ballot=选票
balm=香脂
balmy=芳香
bamboo=竹子
bamboozle=欺骗
ban=禁止
banal=平庸
banana=香蕉
band=乐队
bandage=绷带
bandit=土匪
bandy=班迪球
bane=祸根
bang=砰
banish=放逐
banister=栏杆
bank=银行
banker=银行家
banking=银行业
banknote=钞票
bankrupt=破产
bankruptcy=破产
banner=横幅
banquet=宴会
banter=调侃
bar=酒吧
barb=倒钩
barbarian=野蛮人
barbarous=野蛮
barbecue=烧烤
barber=理发师
barcode=条形码
bard=诗人
bare=裸
barefaced=露骨
barely=仅仅
bargain=便宜货
barge=驳船
bark=吠
barn=谷仓
barometer=晴雨表
baron=男爵
baroque=巴洛克风格
barracks=兵营
barrage=弹幕
barrel=桶
barren=荒芜
barricade=路障
barrier=障碍
barrister=律师
barter=物物交换
base=根据
baseball=棒球
basement=地下室
bashful=腼腆
basic=基本的
basically=基本上
basin=盆地
basis=基础
bask=晒
basket=篮子
basketball=篮球
bass=低音
bassoon=巴松管
baste=绷
bat=蝙蝠
batch=批
bath=洗澡
bathe=洗澡
bather=沐浴者
bathetic=沐浴的
bathroom=浴室
baton=指挥棒
battalion=营
batter=连击
battery=电池
battle=战斗
bauble=玩具
bauxite=铝土矿
bawdy=淫秽的
bawl=呶
bay=湾
bazaar=市场
bbq=烧烤
be=是
beach=海滩
beacon=灯塔
bead=珠子
beak=喙
beam=光束
bean=豆
bear=熊
beard=胡须
bearing=轴承
beast=兽
beat=打
beatific=至福的
beautiful=美丽的
beautify=美化
beauty=美丽
beaver=海狸
because=因为
beckon=招手
become=变得
becoming=成为
bed=床
bedding=寝具
bedeck=床面
bedizen=贝迪森
bedlam=疯人院
bedraggled=衣衫褴褛
bee=蜜蜂
beef=牛肉
beer=啤酒
beet=甜菜
beetle=甲虫
before=前
beforehand=预先
befoul=污秽
befuddle=醉人
befuddlement=困惑
beg=求
beget=产生
beggar=乞丐
begin=开始
beginning=开始
begrudge=怨恨
beguile=欺骗
behalf=代表
behave=表现
behavior=行为
behavioral=行为
behaviour=行为
behavioural=行为
behind=在后面
behold=瞧
beholden=感激
beholder=旁观者
behoove=理应
being=存在
belabor=费力
belated=迟来的
belch=嗝
beleaguer=围攻者
belie=掩饰
belief=信仰
believe=相信
believer=信徒
belittle=贬低
bell=钟
bellicose=好战
belligerence=好战
belligerent=好战的
bellwether=领头羊
belly=腹部
belong=属于
belongings=财物
beloved=心爱
below=以下
belt=腰带
bemused=困惑
bench=长椅
bend=弯曲
beneath=下面
benediction=祝福
benefactor=恩人
beneficial=有利
beneficiary=受益人
benefit=益处
benevolence=仁
benevolent=仁慈
benign=良性
benison=贝尼森
bent=弯曲
bequeath=遗赠
bequest=遗赠
berate=责骂
bereave=丧亲
bereft=丧失
berry=浆果
berserk=狂暴
beset=困扰
beside=旁
besides=除了
besiege=围攻
besmirch=玷污
besot=贝索特
best=最好的
best-seller=畅销书
best-selling=畅销
bestial=兽性的
bestow=赐给
bet=赌注
betoken=预示
betray=背叛
betrayal=背叛
betroth=聘
better=更好的
between=之间
beverage=饮料
beware=提防
bewilder=使困惑
bewildering=扑朔迷离
bewilderment=困惑
bewitching=令人着迷
beyond=超过
bias=偏见
bible=圣经
biblical=圣经的
bibliography=参考书目
bibliophile=藏书家
bibulous=嗜酒的
bicker=斗嘴
bicycle=自行车
bid=出价
bidding=投标
bide=等待
biennial=每两年一次
bifurcate=分叉
big=大的
bigot=偏执者
bigoted=偏执
bike=自行车
bilateral=双边
bile=胆汁
bilingual=双语
bilious=胆汁丰富的
bilk=诈骗
bill=账单
billion=十亿
billionaire=亿万富翁
billow=巨浪
billowy=汹涌澎湃
bin=垃圾桶
bind=绑定
binoculars=双筒望远镜
biochemical=生化
biochemist=生物化学家
biochemistry=生物化学
biographer=传记作家
biographical=传记
biography=传
biological=生物
biologist=生物学家
biology=生物学
biosphere=生物圈
biotechnology=生物技术
biped=两足动物
bird=鸟
birth=出生
birthday=生日
biscuit=饼干
bishop=主教
bison=野牛
bit=少量
bitch=贱人
bite=咬
bitter=苦的
bizarre=奇怪的
black=黑色的
blackball=黑球
blackboard=黑板
blackmail=勒索
blade=刀刃
blame=责备
blanch=漂白
bland=平淡
blandishment=奉承
blank=空白的
blanket=毯子
blare=喧闹声
blasphemy=亵渎
blast=爆炸
blasé=厌倦
blatant=明目张胆
blather=废话
blaze=火焰
blazon=纹章
bleach=漂白
bleachers=看台
bleak=苍凉
bleary=昏昏欲睡
bleed=流血
blemish=缺陷
blend=混合
bless=保佑
blessed=祝福
blessing=祝福
blight=枯萎病
blighted=秕
blind=瞎的
blink=眨
blip=噼啪声
bliss=幸福
blissful=幸福的
blithe=无忧无虑的
blizzard=暴风雪
bloated=臃肿
bloc=集团
block=堵塞
blockade=封锁
blockage=堵塞
blog=博客
blond=金发
blonde=金发女郎
blood=血
bloody=血腥
bloom=盛开
blooming=盛开
blossom=开花
blotch=斑点
blouse=女式衬衫
blow=吹
blowhard=吹牛大王
bludgeon=棍棒
blue=蓝色的
blueprint=蓝图
bluff=虚张声势
blunder=错误
blunt=钝
blur=模糊
blurb=简介
blurt=脱口而出
blush=脸红
bluster=咆哮
blustering=咆哮
board=木板
boast=夸
boastful=自夸的
boat=船
bode=波德
bodily=身体上的
boding=预兆
body=身体
bodyguard=保镖
bog=沼泽
boggle=惊奇
bogus=虚假
bohemian=波西米亚
boil=熬
boiler=锅炉
boisterous=喧闹的
bold=大胆的
bolster=支撑
bolt=螺栓
bomb=炸弹
bombardment=轰击
bombast=夸夸其谈
bombastic=夸夸其谈
bonanza=富矿
bond=纽带
bondage=束缚
bone=骨
bonhomie=友善
bonnet=帽
bonny=美丽
bonus=奖金
bony=骨质的
boo=嘘
book=书
boom=繁荣
boon=恩惠
boor=莽汉
boost=促进
boot=引导
booth=展位
bootless=无引导
border=边界
bore=钻孔
boredom=无聊
boring=无聊的
born=出生
borrow=借
boss=老板
botanical=植物
botany=植物学
botch=失误
both=两个都
bother=打扰
bottle=瓶子
bottleneck=瓶颈
bottom=底部
bough=树枝
boulder=巨石
bounce=弹跳
bouncing=弹跳
bound=边界
boundary=边界
boundless=无边无际
bounteous=丰盛的
bouquet=花束
bourgeois=资产阶级
bout=回合
bovine=牛
bow=弓
bowdlerize=删节
bowel=肠
bower=凉亭
bowl=碗
box=盒子
boxing=拳击
boy=男生
boycott=联合抵制
brace=支撑
bracelet=手镯
bracing=支撑
bracket=括号
brackish=微咸
brag=吹牛
braggadocio=吹牛
braggart=吹牛大王
braid=编织
brain=脑
brake=制动
branch=分支
brand=品牌
brand-new=全新
brandish=挥舞
brandy=白兰地
brash=傲慢
brass=黄铜
brassy=黄铜色的
brat=小子
brattish=顽皮的
bravado=虚张声势
brave=勇敢的
bravery=勇敢
bravura=华丽
brawl=争吵
brawny=强壮的
bray=嘶叫
brazen=厚颜无耻
breach=违反
bread=面包
breadth=宽度
break=休息
breakdown=分解
breakfast=早餐
breakthrough=突破
breast=胸部
breath=气息
breathe=呼吸
breed=品种
breeze=微风
breezeway=走廊
brew=酿造
brewery=啤酒厂
bribe=贿赂
bribery=受贿
brick=砖
bricklayer=瓦工
bride=新娘
bridegroom=新郎
bridge=桥
bridle=辔
brief=简短的
briefcase=公文包
briefing=简报
brigade=旅
bright=明亮的
brighten=增亮
brilliance=光彩
brilliant=杰出的
brim=帽檐
brindled=斑纹的
bring=带来
brink=边缘
brisk=轻快
bristle=鬃
brittle=脆
broach=拉刀
broad=广阔
broadcast=播送
broaden=扩大
brocade=锦缎
brochure=宣传册
broil=烤
broke=打破了
broker=经纪人
bromide=溴化物
bronze=青铜
brooch=胸针
brood=育雏
brook=溪
broom=扫帚
brother=兄弟
brow=眉头
browbeat=威吓
brown=棕色的
browse=浏览
browser=浏览器
bruise=挫伤
bruit=杂音
brunch=早午餐
brunt=冲击
brush=刷子
brusque=粗暴
brutal=野蛮
brutality=残酷
brute=残暴
bubble=气泡
buck=巴克
bucket=桶
buckle=扣上
bucolic=田园风光
bud=芽
buddhism=佛教
buddhist=佛教徒
buddy=伙伴
budge=动摇
budget=预算
budgetary=預算的
buffalo=水牛
buffer=缓冲
buffet=自助餐
buffoon=丑角
bug=漏洞
bugaboo=恐怖
buggy=越野车
build=建造
building=建筑
bulb=电灯泡
bulge=凸出
bulk=大部分
bulky=笨重
bull=公牛
bulldoze=推土机
bullet=子弹
bulletin=公告
bullion=金条
bullish=看涨
bully=欺负
bullyrag=欺凌
bumble=大黄蜂
bump=撞
bumper=保险杠
bumpkinly=乡巴佬
bumptious=傲慢
bunch=束
bundle=捆
bungle=搞糟
buoy=浮标
buoyant=浮力
burden=负担
bureau=局
bureaucracy=官僚
bureaucrat=官僚
bureaucratic=官僚主义
burgeon=发芽
burger=汉堡
burglar=窃贼
burglary=入室盗窃
burial=葬礼
burlesque=滑稽表演
burn=烧伤
burning=燃烧
burnish=打磨
burrow=挖洞
burst=爆裂
bury=埋葬
bus=公共汽车
bush=衬套
bushy=浓密的
business=商业
businessman=商人
bust=摔碎
bustle=忙碌
busy=忙碌的
but=但
butcher=屠夫
butt=屁股
butter=黄油
butterfly=蝴蝶
button=按钮
buttress=支持
buxom=丰满
buy=买
buyer=买方
buzz=嗡嗡声
by=经过
byline=署名
bypass=旁路
byproduct=副产品
bystander=旁观者
byword=代名词
byzantine=拜占庭
cab=出租车
cabal=阴谋
cabbage=卷心菜
cabin=舱
cabinet=内阁
cable=电缆
cache=缓存
cachet=威望
cacophonous=不和谐的
cacophony=不和谐的声音
cactus=仙人掌
cadaver=尸体
cadence=节奏
cadet=学员
cadge=乞讨
cafe=咖啡店
cafeteria=自助餐厅
cage=笼
cajole=哄骗
cake=蛋糕
calamity=灾害
calcium=钙
calculate=计算
calculated=计算
calculating=计算
calculation=计算
calculator=计算器
calculus=结石
caldron=甑
calendar=日历
calf=小牛
caliber=口径
calibrate=校准
calibre=口径
calipers=卡钳
call=称呼
calligraphy=书法
calling=呼叫
callous=冷酷
callow=幼稚的
callus=愈伤组织
calm=冷静的
calorie=卡路里
calumniate=诽谤
calumny=诽谤
camel=骆驼
cameo=客串
camera=相机
camouflage=伪装
camp=营
campaign=活动
campus=校园
can=能
canal=运河
canard=鸭翼
canary=金丝雀
cancel=取消
cancellation=消除
cancer=癌症
candid=坦率
candidacy=候选资格
candidate=候选人
candle=蜡烛
candor=坦诚
candy=糖果
cane=甘蔗
canine=犬科动物
canker=溃疡
cannibalism=食人行为
cannon=大炮
canny=精明的
canoe=独木舟
canon=佳能
canonical=典范
canopy=天篷
canorous=响亮的
cant=不能
cantankerous=脾气暴躁
cantata=康塔塔
canteen=食堂
canto=坎托
canvas=帆布
canvass=帆布
canyon=峡谷
cap=帽
capability=能力
capable=有能力的
capacious=容量大
capacity=容量
cape=岬
caper=跳跃
capillary=毛细管
capital=首都
capitalism=资本主义
capitalist=资本家
capitalize=大写
capitation=人头税
capitulate=投降
caprice=任性
capricious=任性
capsize=倾覆
capsule=胶囊
captain=队长
caption=标题
captious=挑剔
captivate=吸引
captive=俘虏
captivity=囚禁
capture=捕获
car=车
carafe=玻璃水瓶
carapace=甲壳
carat=克拉
caravan=大篷车
carbohydrate=糖类
carbon=碳
carcinogen=致癌物质
card=卡片
cardboard=纸板
cardiac=心脏
cardinal=红衣主教
cardiologist=心脏病专家
care=关心
careen=卡林
career=职业
careful=小心
careless=粗心
caress=抚摸
careworn=忧心忡忡
cargo=货物
caribou=驯鹿
caricature=漫画
carillon=钟琴
carnage=屠杀
carnal=肉欲的
carnivore=食肉动物
carnivorous=肉食性
carol=颂歌
carouse=狂欢
carp=鲤鱼
carpenter=木匠
carpentry=木工
carpet=地毯
carriage=运输
carrier=载体
carrion=腐肉
carrot=胡萝卜
carry=携带
cart=大车
cartilage=软骨
cartographer=制图师
carton=纸盒
cartoon=卡通片
cartoonist=漫画家
carve=雕刻
carving=雕刻
cascade=级联
cascara=卡斯卡拉
case=案件
cash=现金
cashier=出纳员
casino=赌场
cassette=盒式磁带
cast=投掷
caste=种姓
castigate=鞭挞
castigation=惩罚
castle=城堡
casual=随意的
casualty=伤亡
cat=猫
cataclysm=大灾变
catalog=目录
catalogue=目录
catalyst=催化剂
catapult=弹射
catastrophe=灾难
catastrophic=灾难性的
catch=抓住
catching=捕捉
categorical=分类的
category=类别
cater=迎合
caterpillar=毛虫
catharsis=导泻
cathedral=大教堂
catholic=天主教徒
cattle=牛
caucus=核心小组
cauliflower=菜花
caulk=填缝
causal=因果
cause=原因
caustic=腐蚀性的
cauterize=灸
caution=警告
cautionary=警示
cautious=谨慎
cavalcade=行列
cavalier=骑士
cavalry=骑兵
cave=洞穴
caveat=警告
cavern=洞穴
cavil=挑剔
cavity=腔体
cavort=嬉戏
cease=停止
ceaseless=永不停歇
cede=放弃
ceiling=天花板
celcius=摄氏度
celebrate=庆祝
celebrated=著名
celebration=庆典
celebrity=名人
celerity=速度
celestial=天上的
celibate=独身
cell=细胞
cell-phone=手机
cellar=地窖
cello=大提琴
celsius=摄氏度
cement=水泥
cemetery=公墓
censor=审查
censorship=审查制度
censure=谴责
census=人口普查
cent=分
centaur=半人马
centennial=百年
center=中心
centigrade=摄氏度
centimeter=厘米
centimetre=厘米
central=中央
centralise=集中
centralization=集权
centralize=集中
centre=中心
centrifugal=离心
centripetal=向心的
centurion=百夫长
century=世纪
cephalic=头侧
ceramic=陶瓷制品
ceramics=陶瓷
cereal=谷物
cerebral=大脑的
ceremonial=仪式
ceremonious=隆重
ceremony=仪式
certain=肯定
certainly=当然
certainty=肯定
certificate=证书
certification=认证
certify=证明
certitude=确信
cessation=停止
cession=割让
chafe=摩擦
chaff=糠
chaffing=磨擦
chagrin=懊恼
chain=链
chair=椅子
chairman=主席
chairperson=主席
chalice=圣杯
chalk=粉笔
challenge=挑战
challenging=具有挑战性的
chamber=腔体
chameleon=变色龙
champ=冠军
champagne=香槟酒
champion=冠军
championship=锦标赛
chance=机会
chancellor=校长
chandelier=枝形吊灯
change=改变
channel=渠道
chant=呗
chaos=混乱
chaotic=混乱的
chapel=教堂
chaperone=伴侣分子
chapter=章
char=字符
character=特点
characterise=表征
characteristic=特征
characterization=特性
characterize=表征
charade=伪装
charcoal=木炭
charge=收费
charisma=魅力
charitable=慈善
charity=慈善事业
charlatan=庸医
charm=魅力
charming=迷人
chart=图表
charter=宪章
chary=谨慎
chase=追赶
chasm=鸿沟
chaste=贞洁的
chasten=惩戒
chastise=惩罚
chat=聊天
chauvinistic=沙文主义
cheap=便宜的
cheat=欺骗
check=查看
checked=已检查
checkered=格纹
cheek=脸颊
cheeky=厚脸皮
cheer=欢呼
cheerful=快乐
cheese=奶酪
chef=厨师
chemical=化学
chemist=化学家
chemistry=化学
cheque=查看
cherish=珍惜
cherubic=天使般的
chess=棋
chest=胸部
chew=嚼
chic=别致
chicanery=强辩
chicken=鸡
chide=喝叱
chief=首席
chiefly=主要
child=孩子
childish=幼稚
chill=寒意
chilled=冷藏
chilly=寒冷
chimera=嵌合体
chimney=烟囱
chimpanzee=黑猩猩
chin=下巴
china=中国
chip=芯片
chipmunk=花栗鼠
chipper=削片机
chirp=叽叽喳喳
chisel=凿
chivalrous=侠义的
chlorine=氯
chocolate=巧克力
choice=选择
choir=唱诗班
choke=呛
choleric=胆汁质
cholesterol=胆固醇
choose=选择
choosy=挑剔
chop=劈
chopstick=筷子
chord=弦
chore=家务
choreographer=编舞
choreography=编舞
chortle=咯咯笑
chorus=合唱
christ=基督
christian=基督教
christianity=基督教
christmas=圣诞节
chromatic=半音阶
chromosome=染色体
chronic=慢性的
chronical=慢性的
chronically=长期地
chronicle=编年史
chrysanthemum=菊花
chubby=胖乎乎的
chuck=查克
chuckle=咯咯笑
chunk=块
church=教会
churl=吝啬鬼
cigar=雪茄
cigaret=香烟
cigarette=卷烟
ciliate=纤毛虫
cinder=煤渣
cineaste=电影爱好者
cinema=电影
cipher=密碼
circle=圆圈
circuit=电路
circuitous=迂回
circular=圆
circulate=流通
circulation=循环
circumference=圆周
circumlocution=迂回曲折
circumlocutory=詹
circumscribe=限制
circumspect=谨慎
circumstance=环境
circumstantial=间接的
circumvent=规避
circus=马戏团
cistern=水箱
citation=引文
cite=引用
citizen=公民
citizenship=国籍
city=城市
civic=公民
civil=民事
civilian=平民
civilisation=文明
civilise=文明化
civility=礼貌
civilization=文明
civilize=教化
claim=宣称
clairvoyance=千里眼
clairvoyant=千里眼
clam=蛤
clamber=攀
clammy=湿冷
clamor=叫嚣
clamp=夹钳
clan=氏族
clandestine=秘密的
clannish=宗族主义
clap=拍
clarification=澄清
clarify=阐明
clarion=号角
clarity=明晰
clash=冲突
clasp=扣环
class=班级
classic=经典的
classical=古典
classification=分类
classified=已分类
classify=分类
classmate=同学
classroom=课堂
clause=条款
claw=爪
clay=黏土
clean=干净的
cleanse=洁净
clear=清除
clear-cut=明确的
clearance=清除
clearing=清算
clearly=清楚地
cleavage=裂解
cleave=劈开
cleaver=切肉刀
cleft=裂隙
clemency=赦免
clement=克莱门特
clench=紧咬
clergy=牧师
clerical=文职人员
clerk=办事员
clever=聪明的
cliché=陈词滥调
click=点击
client=客户
clientele=客户
cliff=悬崖
climate=气候
climatic=气候
climax=高潮
climb=爬
clinch=成交
cling=紧贴
clinic=诊所
clinical=临床
clip=夹子
clipper=剪刀
clique=集团
cloak=披风
clock=钟
clockwise=顺时针
clog=阻塞
cloister=回廊
clone=克隆
close=关闭
closed-minded=思想封闭
closet=壁橱
closure=关闭
clot=凝块
cloth=布
clothe=穿衣服
clothes=衣服
clothing=衣服
cloture=结束语
cloud=云
cloudburst=暴雨
cloudy=多云
clout=影响力
clown=小丑
cloy=甜美
cloying=令人厌烦
club=俱乐部
clue=线索
clump=丛
clumsy=笨拙
cluster=簇
clutch=离合器
clutter=杂乱
coach=教练
coagulant=凝结剂
coagulate=凝
coagulation=凝血
coal=煤炭
coalesce=合并
coalition=联盟
coarse=粗
coarsen=粗化
coast=海岸
coastal=沿海
coat=外套
coax=哄
cob=玉米芯
cobbler=皮匠
cocaine=可卡因
cock=公鸡
cockpit=座舱
cocktail=鸡尾酒
coconut=椰子
cocoon=茧
coda=结尾
coddle=溺爱
code=代码
codify=编纂
coerce=胁迫
coercion=强迫
coeval=同代
coexist=共存
coexistence=共存
coffee=咖啡
coffer=保险箱
cogent=令人信服
cogitate=深思
cognate=同源词
cognition=认识
cognitive=认知的
cognizance=认知
cognizant=认识到
cognomen=熟知
cohabit=同居
cohere=凝聚
coherence=连贯性
coherent=相干
cohesion=凝聚
cohesive=有凝聚力
coil=线圈
coin=硬币
coinage=造币
coincide=重合
coincidence=巧合
colander=滤器
cold=寒冷的
cold-blooded=冷血
collaborate=合作
collaboration=合作
collaborative=协作
collaborator=合作者
collage=拼贴画
collapse=坍塌
collar=衣领
collate=校对
collateral=抵押品
colleague=同事
collect=收集
collected=集
collection=收藏
collective=集体
collectively=集体
college=大学
collide=碰撞
collision=碰撞
colloquial=口语化的
colloquium=座谈会
colloquy=座谈会
collude=串通
colon=冒号
colonel=上校
colonial=殖民
colonialism=殖民主义
colonise=殖民
colonize=殖民
colonnade=柱廊
colony=殖民地
color=颜色
coloration=着色
colorful=丰富多彩的
colossal=庞大
colossus=巨人
colour=颜色
colourful=丰富多彩的
colt=小马
coltish=马匹
column=柱子
columnist=专栏作家
coma=昏迷
comatose=昏迷
comb=梳子
combat=战斗
combative=好斗的
combination=组合
combine=结合
combustible=易燃
come=来
comedienne=喜剧演员
comedy=喜剧
comely=漂亮
comestible=可食用的
comet=彗星
comfort=舒适
comfortable=舒服的
comic=漫画
comity=礼让
comma=逗号
command=命令
commander=指挥官
commemorate=纪念
commemoration=纪念
commence=开始
commencement=开始
commend=表彰
commendation=表扬
commensurate=相称
comment=评论
commentary=评论
commentator=评论员
commerce=商业
commercial=商业的
commercialise=商业化
commercialize=商业化
commingle=混合
commiserate=怜悯
commission=委员会
commit=犯罪
commitment=承诺
committed=坚定的
committee=委员会
commodious=宽敞的
commodity=商品
common=常见的
commonplace=平凡
commonsense=常识
commonwealth=联邦
commotion=骚动
communal=公共的
commune=公社
communicate=交流
communication=沟通
communicative=交际
communism=共产主义
communist=共产
community=社区
commute=通勤
commuter=通勤者
compact=袖珍的
companion=伴侣
companionship=友谊
company=公司
comparable=可比
comparative=比较
compare=比较
comparison=比较
compartment=隔间
compass=罗盘
compassion=同情
compassionate=富有同情心
compatibility=兼容性
compatible=兼容的
compatriot=同胞
compel=迫使
compelling=引人注目
compendium=概要
compensate=补偿
compensation=赔偿
compensatory=补偿
compete=竞争
competence=权限
competent=胜任的
competition=竞赛
competitive=竞争的
competitor=竞争者
compilation=汇编
compile=编译
complacency=自满
complacent=自满
complain=抱怨
complaint=抱怨
complaisance=顺从
complaisant=顺从的
complement=补充
complementary=补充
complete=完全的
completion=完成
complex=复杂的
complexion=肤色
complexity=复杂
compliance=遵守
compliant=合规
complicate=复杂化
complicated=复杂的
complication=并发症
complicity=共谋
compliment=赞扬
complimentary=免费
comply=遵守
component=成分
comport=行为
compose=撰写
composed=作曲
composer=作曲家
composite=合成的
composition=作品
compost=堆肥
composure=镇静
compound=化合物
comprehend=理解
comprehensible=可以理解
comprehension=理解
comprehensive=综合的
compress=压缩
compression=压缩
comprise=包括
compromise=妥协
compulsion=强迫症
compulsive=强迫症
compulsory=强制性的
compunction=悔恨
computation=计算
compute=计算
computer=电脑
computerise=电脑化
computerize=电脑化
comrade=同志
con=反对派
concatenate=连接
concave=凹
conceal=隐藏
concealment=隐瞒
concede=承认
conceit=自负
conceited=自负
conceive=构想
concentrate=集中
concentration=专注
concentric=同心
concept=概念
conception=概念
conceptual=概念性的
concern=忧虑
concerned=担心的
concerning=有关
concert=音乐会
concerted=协同的
concerto=协奏曲
concession=让步
conciliate=和解
conciliatory=和解
concise=简洁的
conclave=秘密会议
conclude=结论
conclusion=结论
conclusive=确凿
concoct=编造
concomitant=伴随
concord=和睦
concrete=具体的
concur=同意
concurrence=一致同意
concurrent=并发
concussion=脑震荡
condemn=谴责
condemnation=谴责
condensation=缩合
condense=凝结
condescend=屈尊
condescending=居高临下的
condign=条件
condiment=调味品
condition=状况
conditional=有条件的
conditioner=护发素
condole=吊丧
condolence=慰问
condone=纵容
condor=秃鹰
conducive=有利于
conduct=执行
conductivity=电导率
conductor=导体
conduit=导管
cone=锥体
confection=糖果
confederacy=邦联
confederate=同盟者
confederation=联盟
confer=授予
conference=会议
confess=承认
confession=忏悔
confidant=知己
confide=信任
confidence=信心
confident=自信的
confidential=机密的
configuration=配置
confine=局限
confinement=禁闭
confirm=确认
confirmation=确认
confiscate=没收
conflagration=大火
conflate=合并
conflict=冲突
conform=符合
conformist=顺从者
conformity=一致性
confound=混淆
confront=面对
confrontation=对抗
confucian=儒家
confucianism=儒
confuse=迷惑
confusion=困惑
congeal=凝
congenial=相投
congenital=先天性
congest=拥塞
congested=拥挤
congestion=拥塞
conglomerate=大企业集团
congratulate=祝贺
congratulation=祝贺
congratulatory=祝贺
congregate=聚集
congregation=会众
congress=国会
congressional=国会
congressman=众议员
congruent=全等
congruity=一致性
congruous=一致的
conifer=针叶树
conjecture=推测
conjoin=结合
conjugal=婚姻的
conjunction=连词
conjure=变戏法
connect=连接
connection=联系
connexion=连接
connivance=纵容
connive=纵容
connoisseur=行家
connotation=内涵
connubial=婚姻的
conquer=征服
conqueror=征服者
conquest=征服
conscience=良心
conscientious=认真
conscious=有意识的
consciously=有意识地
consciousness=意识
conscript=征兵
consecrate=供奉
consecutive=连续的
consensus=共识
consent=同意
consequence=结果
consequent=随之而来的
consequential=相应的
consequently=最后
conservation=保护
conservative=保守的
conservatory=温室
conserve=养护
consider=考虑
considerable=大量
considerate=周到
consideration=考虑
considering=考虑
consign=交付
consist=包含
consistency=一致性
consistent=持续的
consistently=始终如一
consolation=安慰
console=安慰
consolidate=巩固
consolidation=合并
consonance=和谐
consonant=辅音
consort=配偶
conspectus=概论
conspicuous=显眼的
conspiracy=阴谋
conspire=合谋
constant=持续的
constantly=不断地
constellation=星座
consternation=惊愕
constituency=选区
constituent=组分
constitute=构成
constitution=宪法
constitutional=宪法
constrain=限制
constrained=受限制
constraint=约束
constrict=收缩
constricted=收缩
constringe=收缩
construct=构造
construction=建造
construe=解释
consul=领事
consulate=领事馆
consult=咨询
consultant=顾问
consultation=咨询
consultative=咨询
consume=消耗
consumer=消费者
consummate=完善
consumption=消耗
contact=接触
contagious=传染性
contain=包含
container=容器
containment=遏制
contaminate=污染
contamination=污染
contemn=蔑视
contemplate=思考
contemplation=沉思
contemplative=沉思的
contemporary=当代的
contempt=鄙视
contemptible=可鄙
contemptuous=轻蔑的
contend=抗衡
content=内容
contented=满足
contention=争执
contentious=有争议的
contest=竞赛
contestant=选手
context=语境
contextual=语境
contiguous=连续的
continent=大陆
continental=大陆
contingent=队伍
continual=持续
continually=不断地
continuation=延续
continue=继续
continuity=连续性
continuous=连续的
continuum=连续体
contort=扭曲
contour=轮廓
contraband=违禁品
contract=合同
contraction=收缩
contractor=承包商
contradict=顶撞
contradiction=矛盾
contradictory=矛盾的
contrary=相反
contrast=对比
contravene=违反
contribute=贡献
contribution=贡献
contributor=贡献者
contrite=悔恨
contrition=悔罪
contrive=谋划
contrived=做作的
control=控制
controversial=有争议的
controversy=争议
controvert=反驳
contumacious=顽固的
contumacy=顽固
contumely=傲慢
conundrum=难题
convalesce=疗养
convalescent=康复期
convection=对流
convene=召开
convenience=方便
convenient=方便的
convention=习俗
conventional=传统的
converge=汇聚
convergence=收敛
convergent=收敛
conversant=熟稔的
conversation=对话
converse=交谈
conversion=转换
convert=转变
convertible=敞篷车
convex=凸
convey=传达
conveyance=输送
convict=定罪
conviction=定罪
convince=说服
convincing=令人信服
convivial=欢乐的
conviviality=欢乐
convoke=召开
convoluted=复杂的
convoy=护航
convulse=抽搐
convulsion=抽搐
cook=厨师
cooker=炊具
cookie=曲奇饼
cool=凉爽的
coop=合作社
cooperate=合作
cooperation=合作
cooperative=合作
coordinate=协调
coordination=协调
coordinator=协调员
cop=警察
cope=应付
copious=丰富
copper=铜
copy=复制
copyright=版权
coral=珊瑚
cord=绳索
cordial=亲切
cordiality=热情
core=核
cork=软木
corn=玉米
corner=角落
cornerstone=基石
cornet=短号
cornucopia=聚宝盆
corny=陈词滥调
corona=电晕
coronation=加冕
corporal=下士
corporate=公司的
corporation=公司
corporeal=肉体的
corps=兵团
corpse=尸体
corpulent=肥胖的
corpus=语料库
corpuscle=血球
corral=畜栏
correct=正确的
correction=更正
corrective=矫正
correlate=相关
correlation=相关性
correlative=对应词
correspond=对应
correspondence=一致
correspondent=记者
corresponding=相应的
corridor=走廊
corroborate=证实
corrode=腐蚀
corrosion=腐蚀
corrosive=腐蚀性的
corrugate=起皱
corrugated=瓦楞
corrupt=腐败
corruption=腐败
coruscate=焕发
cosmetic=化妆品
cosmic=宇宙的
cosmopolitan=国际化
cosmopolitanism=世界主义
cosmos=宇宙
cosset=溺爱
cost=成本
costly=昂贵
costume=戏服
cosy=舒适
cosy(cozy)=寬闊（寬闊）
coterie=小圈子
coterminous=相邻的
cottage=小屋
cotton=棉布
couch=长椅
cougar=美洲狮
cough=咳嗽
could=可以
council=理事会
councillor=议员
councilor=顾问
counsel=法律顾问
counseling=咨询
counsellor=顾问
counselor=顾问
count=数数
countdown=倒计时
countenance=面容
counter=柜台
counteract=抵消
counteraction=反作用
counterbalance=抗衡
counterfeit=伪造
countermand=撤销命令
counterpart=对应方
counterpoise=平衡
counterproductive['kautəprə,dʌktiv]=适得其反ʌ離開]
countless=无数
countrified=乡村化
country=国家
countryside=农村
county=县
coup=政变
coup d'état=政变
couple=夫妻
coupon=优惠券
courage=勇气
courageous=勇敢
course=课程
court=法庭
courteous=有礼貌
courtesy=礼貌
courtyard=庭院
cousin=表哥
coven=女巫集会
covenant=盟约
cover=覆盖
coverage=覆盖范围
covert=隐蔽
covet=贪图
covetous=贪婪
cow=奶牛
coward=懦夫
cowardice=怯懦
cowardly=胆小
cowboy=牛仔
cower=退缩
coy=腼腆
cozen=欺骗
cozy=舒适
crab=螃蟹
crabbed=脾气暴躁
crack=裂缝
crackdown=镇压
cracker=饼干
crackpot=疯子
cradle=摇篮
craft=工艺
crafty=狡猾
crag=岩
cram=填鸭式
cramp=抽筋
cramped=狭窄
crane=起重机
cranky=暴躁的
crash=碰撞
crass=粗俗
crate=箱
crater=陨石坑
cravat=领结
crave=渴望
craven=懦夫
craving=渴求
crawl=爬行
crayon=蜡笔
craze=狂热
crazy=疯狂的
cream=奶油
creamy=奶油状
crease=折痕
create=创造
creation=创建
creative=有创造力的
creativity=创造力
creator=創作者
creature=生物
credence=信任
credential=凭据
credibility=信誉
credible=可信的
credit=信用
creditable=值得信赖
credo=信条
credulous=轻信
creed=信条
creek=溪
creep=蠕变
crepuscular=黄昏的
crescendo=渐强
crest=波峰
crestfallen=垂头丧气
crevice=裂缝
crew=全体人员
crib=婴儿床
cricket=蟋蟀
crime=犯罪
criminal=刑事
crimp=卷曲
cringe=畏缩
cringing=畏缩
crinkle=皱褶
cripple=削弱
crippling=致残
crisis=危机
crisp=脆
crisscross=交错
criteria=标准
criterion=标准
critic=评论家
critical=批判的
criticise=批评
criticism=批评
criticize=批评
critique=批判
croak=发牢骚
crochet=钩针编织
crockery=陶器
crocodile=鳄鱼
cronyism=任人唯亲
crook=骗子
crooked=歪
croon=轻哼
crop=庄稼
cross=叉
crossing=穿越
crotchety=脾气暴躁
crouch=蹲伏
crow=乌鸦
crowd=人群
crowded=挤
crown=王冠
crucial=至关重要的
crude=原油
crudity=粗鲁
cruel=残忍的
cruelty=残酷
cruise=巡航
cruiser=巡洋舰
crumb=屑
crumble=崩溃
crumple=揉皱
crunch=嘎吱嘎吱
crusade=运动
crush=压碎
crust=地壳
crustacean=甲壳类
crutch=拐杖
crux=症结
cry=哭
cryogenic=低温
crypt=墓穴
cryptic=隐秘的
crystal=水晶
cub=幼兽
cube=立方体
cubic=立方体
cubicle=小隔间
cucumber=黄瓜
cuddle=偎
cue=提示
cuff=袖口
cuisine=美食
culinary=烹饪
cull=剔除
culminate=达到顶峰
culmination=顶点
culpable=有罪的
culprit=罪魁祸首
cult=邪教
cultivate=培育
cultivated=栽培的
cultivation=栽培
cultural=文化
culture=文化
cumber=阻碍
cumbersome=繁琐
cumulative=累积
cumulus=积云
cuneiform=楔形文字
cunning=狡猾
cup=杯子
cupboard=橱柜
cupidity=贪婪
curable=可治愈
curator=馆长
curb=抑制
curd=凝乳
curdle=凝固
cure=治愈
curfew=宵禁
curiosity=好奇心
curious=好奇的
curl=卷曲
curmudgeon=脾气暴躁的人
currency=货币
current=当前的
currently=现在
curriculum=课程
currish=粗俗的
curse=诅咒
cursive=草書
cursory=粗略的
curt=简短
curtail=削减
curtain=窗帘
curvaceous=曲线美
curve=曲线
cushion=软垫
custodian=保管人
custody=保管
custom=风俗
customary=习惯的
customer=顾客
customs=海关
cut=切
cute=可爱的
cuticle=表皮
cutlery=刀具
cyberspace=网络空间
cycle=循环
cyclical=周期性的
cycling=骑自行车
cyclist=骑自行车的人
cyclone=气旋
cygnet=小天鹅
cylinder=圆柱
cynic=犬儒
cynical=愤世嫉俗的
cynicism=玩世不恭
cynosure=焦点
cypress=柏
cytology=细胞学
dab=轻拍
dabble=玩水
dabbler=半瓶醋
dad=爸爸
daddy=爸爸
daft=愚蠢
dagger=匕首
daguerreotype=银版照相术
daily=日常的
dainty=纤巧
dairy=奶制品
dalliance=调戏
dally=玩弄
dam=坝
damage=损害
damn=该死
damp=潮湿
damped=阻尼
dampen=挫伤
damper=阻尼器
dance=舞蹈
dandy=花花公子
danger=危险
dangerous=危险的
dangle=悬垂
dank=潮湿
dapper=衣冠楚楚
dappled=斑驳的
dare=敢
daredevil=冒失鬼
daring=大胆
dark=黑暗的
darken=变暗
darkness=黑暗
darling=亲爱的
dart=镖
dash=短跑
dashing=潇洒
dastard=卑鄙小人
data=数据
database=数据库
date=日期
dated=过时的
dating=约会
datum=基准
daub=涂抹
daubster=达布斯特
daughter=女儿
daunt=吓住
dauntless=勇敢的
dawdle=混日子
dawn=黎明
day=天
daylight=日光
daze=发呆
dazzle=炫
dazzling=令人眼花缭乱
deactivate=停用
dead=死的
deaden=缓和
deadline=最后期限
deadlock=僵局
deadly=致命
deadpan=面无表情
deaf=聋
deal=交易
dealer=经销商
dealing=处理
dean=院长
dear=亲爱的
dearth=缺乏
death=死亡
debacle=崩溃
debar=德巴
debark=下船
debase=贬低
debatable=值得商榷
debate=辩论
debilitate=使人衰弱
debility=虚弱
debonair=温文尔雅
debouch=出入口
debrief=汇报
debris=碎片
debt=债务
debtor=债务人
debunk=揭穿真相
debut=首次亮相
decade=十年
decadence=颓废
decamp=逃走
decant=滗析
decay=衰变
deceit=欺骗
deceitful=欺骗性的
deceive=欺骗
december=十二月
decency=正派
decent=体面的
decentralize=分散化
deception=欺骗
deceptive=欺骗性的
decibel=分贝
decide=决定
deciduous=落叶
decimal=十进制
decimate=消灭
decipher=解码
decision=决定
decisive=决定性
deck=甲板
declaim=宣告
declamation=宣读
declaration=宣言
declarative=声明式
declare=宣布
declassify=解密
declination=偏角
decline=衰退
declivity=倾斜度
decode=解码
decompose=分解
decomposition=分解
decorate=装饰
decoration=装饰
decorative=装饰性的
decorum=礼仪
decoy=诱饵
decrease=减少
decree=法令
decrepit=衰老
decry=谴责
dedicate=奉献
dedication=奉献
deduce=推断
deducible=可扣除
deduct=扣除
deductible=免赔额
deduction=扣除
deductive=演绎的
deed=契据
deem=认为
deep=深的
deeply=深
deer=鹿
deface=污损
defalcate=放债
defame=诽谤
default=默认
defeat=击败
defeatist=失败主义者
defect=缺点
defection=叛逃
defective=有缺陷的
defence=防御
defend=保卫
defendant=被告
defense=防御
defensive=防御
defer=推迟
deference=尊重
deferential=恭敬的
defiance=蔑视
defiant=挑衅
deficiency=不足
deficient=不足
deficit=赤字
defile=玷污
define=定义
defined=定义
definite=定
definitely=确实
definition=定义
definitive=确定的
deflated=瘪
deflect=偏转
defoliant=落叶剂
defoliate=落叶
defoliator=落叶机
deforest=砍伐森林
deforestation=森林砍伐
deform=变形
defraud=骗取
defray=支付
deft=麻利
defunct=已不复存在
defuse=拆除
defy=违抗
degenerate=退化
degeneration=退化
degradation=降解
degrade=降级
degree=程度
dehydrate=脱水
deify=神化
deign=设计
deity=神
dejected=垂头丧气
delay=延迟
delectable=美味可口的
delectation=愉悦
delegate=代表
delegation=代表团
delete=删除
deleterious=有害的
deletion=删除
deliberate=商榷
deliberately=故意地
deliberation=审议
delicacy=美味
delicate=精美的
delicious=可口的
delight=喜
delightful=愉快
delimit=划界
delineate=描绘
delinquency=违法行为
delinquent=违法
delirious=精神错乱
delirium=谵妄
deliver=递送
delivery=送货
delta=三角洲
delude=欺骗
deluge=洪水
delusion=妄想
deluxe=豪华
delve=深入研究
demagogue=煽动者
demand=要求
demanding=要求苛刻
demarcate=标定
demean=贬低
demeanour=风度
demented=痴呆
demise=消亡
demo=演示
democracy=民主
democrat=民主党人
democratic=民主
demographic=人口统计
demography=人口统计
demolish=拆除
demolition=拆除
demonstrate=证明
demonstration=示范
demonstrative=示范性的
demoralize=使士气低落
demote=降级
demotic=世俗体
demur=反对
demure=端庄
demystify=揭开神秘面纱
den=巢穴
denial=拒绝
denigrate=诋毁
denim=牛仔布
denizen=居民
denominate=定名
denomination=面值
denotation=表示
denote=表示
denouement=结局
denounce=声讨
dense=稠密
density=密度
dent=凹痕
dental=牙科
dentist=牙医
denture=假牙
denude=剥夺
denunciate=谴责
denunciation=谴责
deny=否定
depart=离开
department=部门
departure=离开
depend=依赖
dependable=可靠
dependence=依赖
dependent=受抚养人
depict=描绘
depiction=描写
deplete=消耗
depletion=消耗
deplore=痛惜
deploy=部署
deployment=部署
deport=驱逐出境
deportation=驱逐出境
deportment=仪态
depose=免职
deposit=订金
deposition=沉积
depot=仓库
depraved=堕落的
depravity=堕落
deprecate=弃用
depreciate=贬值
depreciation=折旧
depredation=掠夺
depress=压抑
depressant=镇静剂
depressed=郁闷
depression=沮丧
deprivation=剥夺
deprive=剥夺
depth=深度
depute=代表
deputize=代理
deputy=副
deracinate=灭绝
derail=脱轨
derailment=脱轨
derange=扰乱
deranged=精神错乱
derangement=错乱
deregulate=放松管制
deregulation=放松管制
derelict=废弃的
dereliction=失职
deride=嘲笑
derivation=推导
derivative=衍生物
derive=派生
dermatologist=皮肤科医生
derogate=减损
derogatory=贬
desalinize=脱盐
descend=下降
descendant=后裔
descent=下降
describe=描述
description=描述
descriptive=描述性的
descry=揭露
desecrate=亵渎
desert=沙漠
deserted=荒废
deserter=逃兵
desertion=叛逃
deserve=应得
desiccate=干燥
desideratum=迫切需要
design=设计
designate=指定
designation=指定
designer=设计师
designing=设计
desirability=可取性
desirable=可取之处
desire=欲望
desirous=渴望
desist=停止
desk=桌子
desktop=桌面
desolate=荒凉
despair=绝望
despatch=派遣
desperado=亡命之徒
desperate=绝望的
despicable=卑鄙
despise=鄙视
despite=尽管
despoil=掠夺
despondent=沮丧的
despot=暴君
despotic=专制
despotism=专制
dessert=甜点
destination=目的地
destine=注定
destined=注定
destiny=命运
destitute=贫困
destitution=赤贫
destroy=破坏
destructible=可破坏
destruction=破坏
destructive=破坏性的
desuetude=废止
desultory=断断续续的
detach=分离
detached=分离的
detachment=分离
detail=细节
detailed=详细的
detain=扣留
detect=探测
detection=检测
detective=侦探
detention=拘留
deter=阻止
detergent=洗涤剂
deteriorate=恶化
deterioration=恶化
determinant=决定因素
determination=决心
determine=决定
determined=决定
deterrent=威慑
detest=厌恶
detestable=可恨
detonate=起爆
detonation=爆炸
detour=車輛改道
detract=贬损
detraction=诽谤
detriment=损害
detrimental=有害的
detritus=碎屑
devastate=蹂躏
devastating=毁灭性的
devastation=破坏
develop=发展
developer=开发商
development=发展
developmental=发展
deviant=异常
deviate=偏离
deviation=偏差
device=设备
devil=魔鬼
devious=狡猾的
devise=设计
devoid=沒有
devolve=下放
devote=奉献
devoted=虔诚
devotee=虔诚者
devotion=虔诚
devotional=虔诚的
devour=吞食
devout=虔诚
dew=露
dexterity=灵巧
dexterous=轻巧
diabetes=糖尿病
diabolic=恶魔般的
diabolical=恶魔般的
diagnose=诊断
diagnosis=诊断
diagonal=对角线
diagram=图表
dial=拨号
dialect=方言
dialog=对话
dialogue=对话
diameter=直径
diamond=钻石
diaphanous=透明的
diary=日记
diatribe=长篇大论
dicker=还价
dictate=听写
dictation=听写
dictator=独裁者
dictatorial=独裁的
diction=措辞
dictionary=字典
dictum=格言
didactic=教学
die=死
diehard=顽固
diesel=柴油机
diet=饮食
dietary=饮食
dietetics=营养学
differ=不同
difference=不同之处
different=不同的
differentiate=区分
differentiation=分化
difficult=难的
difficulty=困难
diffident=缺乏自信
diffuse=扩散
diffusion=扩散
dig=挖
digest=消化
digestion=消化
digestive=消化
digit=数字
digital=数字的
dignified=凝重
dignify=尊贵化
dignitary=贵宾
dignity=尊严
digress=离题
digression=离题
dike=堤
dilapidate=破坏
dilapidated=破旧不堪
dilapidation=破败
dilate=扩张
dilatory=拖拉
dilemma=困境
dilettante=业余爱好者
diligence=勤勉
diligent=勤奋
dillydally=拖拖拉拉
dilute=稀
dilution=稀释
dim=暗淡
dime=一角钱
dimension=方面
dimensional=维度
diminish=减少
diminuendo=渐弱
diminution=减少
diminutive=微小的
dimple=酒窝
din=喧闹
dine=用餐
diner=晚餐
dingy=肮脏的
dinner=晚餐
dinosaur=恐龙
diocesan=教区
dioxide=二氧化碳
dip=蘸
diploma=文凭
diplomacy=外交
diplomat=外交官
diplomatic=外交
dipsomania=酒瘾
dire=可怕的
direct=直接的
direction=方向
director=导演
directory=目录
dirge=挽歌
dirt=污垢
dirty=肮脏的
disability=残疾
disable=禁用
disabled=已禁用
disabuse=消除误解
disadvantage=缺点
disaffect=不满
disagree=不同意
disagreeable=令人不快的
disagreement=分歧
disappear=消失
disappearance=消失
disappoint=辜负
disappointing=令人失望
disappointment=失望
disapproval=不赞成
disapprove=不赞成
disarm=解除武装
disarmament=裁军
disarming=解除武装
disarrange=扰乱
disarray=混乱
disaster=灾难
disastrous=灾难性的
disavow=否认
disband=解散
disbar=取消律师资格
disburse=支付
disc=光盘
discard=丢弃
discern=辨别
discernible=可辨别的
discerning=有辨别力的
discharge=释放
disciple=弟子
disciplinary=纪律处分
discipline=纪律
disciplined=纪律严明
disclaim=放弃
disclaimer=免责声明
disclose=透露
disclosure=信息披露
disco=迪斯科
discography=唱片目录
discombobulate=使混乱
discombobulated[,diskʌm'bɔbjuleitid]=混乱的[,磁盘ʌ嗯ɔ猶太人類
discomfit=使人不安
discomfited=沮丧
discomfiture=窘迫
discompose=惊
disconcert=搅乱
discord=不和谐
discount=折扣
discourage=阻碍
discourse=话语
discover=发现
discovery=发现
discredit=抹黑
discreet=慎重
discrepancy=差异
discrete=离散的
discretion=审慎
discretionary=酌情
discriminate=辨析
discrimination=歧视
discriminatory=歧视性的
discursive=话语的
discuss=讨论
discussion=讨论
disdain=蔑视
disease=疾病
disembodied=无形的
disembody=脱离肉体
disenchant=解除魔咒
disengage=脱离
disentangle=解开
disfigure=变丑
disfranchise=剥夺权利
disgorge=吐出
disgrace=耻辱
disgruntle=不满
disguise=伪装
disgust=厌恶
disgusting=令人恶心
dish=盘子
dishearten=灰心丧气
dishevel=凌乱
disheveled=衣冠不整
disillusion=幻灭
disinfect=消毒
disinfectant=消毒剂
disintegrate=瓦解
disintegration=解体
disinter=发掘
disinterested=不感兴趣的
disjunction=分离
disjunctive=析取的
disk=磁盘
dislike=不喜欢
dislocate=脱臼
dislodge=驱逐
dismal=惨淡
dismantle=拆除
dismay=沮丧
dismiss=解雇
dismissal=解雇
disorder=紊乱
disparage=贬损
disparate=不同的
disparity=差距
dispassionate=冷静
dispatch=派遣
dispel=打消
dispensable=可有可无
dispense=分配
disperse=分散
displace=取代
displacement=位移
display=展示
disport=玩耍
disposable=一次性的
disposal=处理
dispose=处理
disposed=已处置
disposition=处置
disproof=反驳
disprove=反驳
disputable=有争议的
dispute=争议
disquisition=论述
disregard=漠视
disreputable=声名狼藉
disrepute=声名狼藉
disrespectful=不尊重
disrupt=扰乱
disruption=中断
disruptive=破坏性的
dissect=解剖
dissection=解剖
dissemble=掩饰
disseminate=传播
dissent=异议
dissertation=论文
dissident=异见人士
dissimilar=不相似的
dissimulate=掩饰
dissipate=消散
dissociate=游离
dissociation=解离
dissolute=荒淫
dissolve=溶解
dissonant=不和谐的
dissuade=劝阻
distain=鄙视
distal=远端
distance=距离
distant=遥远
distend=扩张
distension=膨胀
distention=膨胀
distil=蒸馏
distill=蒸馏
distillation=蒸馏
distinct=清楚的
distinction=区别
distinctive=独特的
distinguish=区分
distinguishable=可区分
distinguished=杰出的
distort=歪曲
distortion=失真
distract=转移
distracted=愣
distraction=分心
distrait=分散
distraught=心烦意乱
distress=苦恼
distressed=苦恼
distressful=痛苦的
distribute=分发
distribution=分配
distributive=分配的
district=区
disturb=打扰
disturbance=骚乱
disunite=分裂
ditch=沟
dither=抖动
ditty=小曲
diurnal=昼夜
diva=天后
divagate=离题
dive=潜水
diver=潜水员
diverge=发散
divergent=分歧
divers=潜水员
diverse=各种各样的
diversification=多样化
diversify=多样化
diversion=导流
diversity=多样性
divert=转移
divest=撤资
divestiture=资产剥离
divide=划分
dividend=股利
divine=神圣的
division=分配
divisive=分裂
divorce=离婚
divulge=泄露
dizzy=晕眩的
do=做
docile=温顺
dock=码头
doctor=医生
doctoral=博士
doctorate=博士学位
doctrinaire=教条主义者
doctrine=教义
document=文档
documentary=记录
documentation=文档
dodder=菟
dodge=躲闪
doff=脱
dog=狗
dogged=顽强的
doggerel=打油诗
doggo=狗狗
dogma=教条
dogmatic=教条的
dogmatism=教条主义
doldrums=低迷
dole=救济金
doleful=悲哀的
doll=玩具娃娃
dollar=美元
dolorous=悲痛的
dolphin=海豚
dolt=笨蛋
domain=领域
dome=圆顶
domestic=国内的
domesticate=驯化
domicile=住所
dominance=统治地位
dominant=主导的
dominate=支配
domination=统治
domineering=盛气凌人
dominion=统治
donate=捐
donation=捐款
donkey=驴
donor=捐助者
doodle=涂鸦
doom=厄运
doomed=注定失败
door=门
dorm=宿舍
dormancy=休眠
dormant=蛰伏
dormitory=宿舍
dorsal=背部
dosage=剂量
dose=剂量
dossier=卷宗
dot=点
dotage=溺爱
dote=宠爱
doting=溺爱
double=双倍的
double-cross=背叛
doubt=怀疑
doubtful=疑
doubtless=毫无疑问
dough=面团
dour=阴沉
douse=浇淋
dove=鸽子
dowdy=邋遢的
down=向下
down-to-earth=脚踏实地
downcast=沮丧
downgrade=降级
downhearted=消沉
download=下载
downplay=淡化
downpour=倾盆大雨
downstairs=楼下
downtown=市中心
downward=向下
downwards=向下
dowry=嫁妆
dowse=探探
doyen=元老
doze=瞌睡
dozen=打
drab=单调
draconian=严酷的
draft=草稿
draftsmanship=绘图技巧
drag=拖
draggy=拖沓
dragon=龙
drain=流走
drainage=引流
drama=戏剧
dramatic=戏剧性
dramatically=戏剧性地
drastic=激烈的
drastically=急剧地
draw=画
drawback=退税
drawbridge=吊桥
drawer=抽屉
drawing=绘画
drawl=拖长声音
drawn=绘制
dread=恐惧
dreadful=可怕
dream=梦
dreamy=梦幻般的
dreary=凄凉
dregs=渣
drench=淋
drenched=湿透
dress=裙子
dressing=敷料
dribble=运球
drift=漂移
drill=钻头
drink=喝
drip=滴
drive=驾驶
drivel=胡言乱语
driver=司机
drizzle=细雨
drizzly=蒙蒙
droll=滑稽
drollery=笑话
drone=无人机
drool=流口水
droop=下垂
drop=降低
droplet=液滴
dropout=辍学
dross=浮渣
drought=干旱
drove=开车
drown=淹没
drowsy=昏昏欲睡
drub=德鲁布
drudgery=苦差事
drug=药品
drum=鼓
drunk=醉
drunkard=酒鬼
drunken=醉
dry=干燥
dryer=烘干机
dual=双重的
dub=配音
dubious=可疑
duck=鸭子
duckling=小鸭
duct=管
ductile=延展性
due=到期的
duel=决斗
duet=二重奏
dulcet=悦耳的
dull=乏味的
dullard=愚笨的人
duly=适当地
dumb=哑的
dumbfound=惊呆了
dummy=假的
dump=倾倒
dunce=笨蛋
dune=沙丘
dungeon=地牢
dupe=欺骗
duplicate=复制
duplication=复制
duplicitous=口是心非
duplicity=表里不一
durability=耐久性
durable=耐用的
duration=期间
duress=胁迫
during=期间
dusk=黄昏
dusky=昏暗
dust=灰尘
dusty=尘土飞扬
dutiful=尽职尽责
duty=责任
dwarf=矮人
dwell=住
dweller=居住者
dwelling=住宅
dwindle=逐渐减少
dye=染料
dying=死亡
dynamic=动态的
dynamics=动力学
dynamo=发电机
dynasty=王朝
dysfunctional=功能失调
dyslexia=阅读障碍
dyspeptic=消化不良
each=每个
eager=渴望的
eagle=鹰
eaglet=小鹰
ear=耳朵
early=早期的
earn=赚
earnest=认真
earnings=收益
earplug=耳塞
earring=耳环
earshot=耳边传来
earsplitting=震耳欲聋
earth=地球
earthly=尘世的
earthquake=地震
earthshaking=惊天动地
earthy=泥土的
ease=舒适
easel=画架
easily=容易地
east=东方
easter=复活节
eastern=东
easy=简单的
easy-going=随和
eat=吃
eavesdrop=窃听
ebb=落潮
ebullience=沸腾
eccentric=偏心
ecdysis=蜕皮
echo=回声
eclat=埃克拉
eclectic=折衷的
eclecticism=折衷主义
eclipse=蚀
eclogue=牧歌
ecological=生态
ecologist=生态学家
ecology=生态
economic=经济的
economical=经济
economics=经济学
economist=经济学家
economize=节约
economy=经济
ecosystem=生态系统
ecstasy=狂喜
ecstatic=欣喜若狂
ecumenical=普世的
eddy=涡流
edge=边缘
edgy=急躁
edible=食用
edict=法令
edifice=大厦
edify=启迪
edit=编辑
edition=版
editor=编辑
editorial=社论
educate=教育
education=教育
educational=教育
educator=教育家
eerie=怪异
efface=抹去
effect=影响
effective=有效的
effectuate=实现
effeminate=娘娘腔
effervesce=冒泡
effete=衰弱
efficacious=有效的
efficacy=功效
efficiency=效率
efficient=高效的
effigy=肖像
effluvia=恶臭
effort=努力
effrontery=厚颜无耻
effulgent=光辉灿烂
effuse=流出
egalitarian=平等主义
egg=蛋
eggplant=茄子
ego=自我
egocentric=自我中心
egoism=利己主义
egoist=利己主义者
egotist=自负者
egregious=令人震惊的
egress=出口
eight=八
eighteen=十八
eighth=第八
eighty=八十
either=任何一个
ejaculate=射精
eject=喷射
ejection=弹射
elaborate=精心制作的
elaboration=详尽阐述
elapse=流逝
elastic=松紧带
elasticity=弹性
elated=兴高采烈
elation=兴高采烈
elbow=弯头
elder=长老
elderly=老年
elect=选
election=选举
elective=选修课
electoral=选举
electorate=选民
electric=电的
electrical=电气
electrician=电工
electricity=电
electron=电子
electronic=电子的
electronically=电子地
electronics=电子产品
elegance=优雅
elegant=优雅的
elegy=挽歌
element=元素
elementary=初级
elephant=大象
elephantine=象
elevate=提升
elevation=海拔
elevator=电梯
eleven=十一
elicit=引出
eligibility=合格
eligible=有资格的
eliminate=排除
elimination=消除
elite=精英
elixir=灵丹妙药
ellipsis=省略
elliptical=椭圆形
elm=榆树
elocution=演说
elongate=拉长
eloquence=口才
eloquent=雄辩
else=别的
elsewhere=别处
elucidate=阐发
elude=躲避
elusive=难以捉摸
elysian=极乐世界
emaciate=消瘦
emaciated=瘦弱
emaciation=消瘦
email=电子邮件
emanate=发出
emancipate=解放
emancipation=解放
emasculate=阉割
embalm=防腐
embankment=堤
embargo=禁运
embark=出发
embarrass=使尴尬
embarrassment=尴尬
embassy=大使馆
embed=嵌入
embellish=润
embezzle=挪用
embezzlement=挪用公款
embitter=苦涩
emblazon=纹章
emblem=徽
emblematic=象征性的
embodiment=实施例
embody=体现
embolden=鼓舞
emboss=浮雕
embrace=拥抱
embroider=绣
embroidery=刺绣
embroil=纠缠
embryo=胚胎
embryonic=胚胎
emend=订正
emerald=翠
emerge=出现
emergence=出现
emergency=紧急情况
emigrant=移民
emigrate=移民
emigration=移民
eminence=卓越
eminent=杰出
emissary=使者
emission=排放
emit=发射
emollient=润肤剂
emolument=薪酬
emote=表情
emotion=情感
emotional=情感
empathy=共情
emperor=皇帝
emphasis=强调
emphasise=强调
emphasize=强调
emphatic=强调
empire=帝国
empirical=经验
empiricism=经验主义
employ=采用
employee=员工
employer=雇主
employment=就业
empower=授权
empress=皇后
emptiness=空虚
empty=空的
empyreal=至高天
empyrean=至高天
emulate=仿真
emulation=仿真
emulsify=乳化
enable=使能够
enact=制定
enactment=制定法
enamel=搪瓷
enamored=迷恋
encapsulate=封装
encase=包住
enchant=附魔
encipher=加密
enclose=括
enclosure=外壳
encomiast=赞美者
encomiastic=赞美的
encomium=颂词
encompass=包含
encounter=遇到
encourage=鼓励
encouragement=鼓励
encouraging=令人鼓舞
encroach=侵犯
encumber=妨碍
encyclopaedia=百科全书
encyclopedia=百科全书
encyclopedic=百科全书式的
end=结尾
endanger=危害
endangered=濒危
endearing=讨人喜欢
endeavor=努力
endeavour=努力
endemic=地方性
ending=结束
endless=无尽的
endorse=赞同
endorsement=代言
endow=赋予
endowment=捐赠
endue=赋予
endurance=耐力
endure=忍受
enduring=持久
enemy=敌人
energetic=精力充沛
energetically=精力充沛地
energize=通电
energy=活力
enervate=使人衰弱
enfeeble=衰弱
enfetter=恩费特
enflame=激起
enforce=执行
enforcement=执法
engage=从事
engaged=已订婚的
engagement=订婚
engaging=引人入胜
engender=产生
engine=引擎
engineer=工程师
engineering=工程
engrave=雕刻
engraving=雕刻
engross=独占
engrossed=全神贯注
engrossment=全神贯注
engulf=吞噬
enhance=提高
enhancement=增强
enigma=谜
enigmatic=神秘莫测
enjoin=责成
enjoy=享受
enjoyable=令人愉快的
enjoyment=享受
enlarge=放大
enlighten=开导
enlightening=启发
enlightenment=启示
enlist=征募
enliven=活跃
enmesh=纠缠
enmity=敌意
ennoble=使高贵
ennui=厌倦
enormity=巨大
enormous=巨大的
enough=足够的
enquire=查询
enquiry=询问
enrage=激怒
enrapture=狂喜
enrich=丰富
enrol=注册
enroll=注册
enrollment=注册
enrolment=注册
ensconce=安放
ensemble=合奏
enshrine=供奉
ensign=军旗
enslave=奴役
ensnare=诱捕
ensue=随之而来
ensure=确保
entail=蕴涵
entangle=绞
enter=进入
enterprise=企业
enterprising=进取
entertain=招待
entertaining=娱乐
entertainment=娱乐
enthrall=迷住
enthralling=令人着迷
enthusiasm=热情
enthusiast=爱好者
enthusiastic=热情的
enthusiastically=踊跃
entice=诱惑
entire=全部的
entirety=整体
entitle=享有
entitled=有权
entity=实体
entourage=随行人员
entrance=入口
entrancing=令人着迷
entrap=陷害
entreat=恳求
entreaty=恳求
entrench=巩固
entrepreneur=企业家
entrepreneurial=创业型
entrust=委托
entry=入口
entrée=主菜
entwine=缠绕
enumerate=枚举
enunciate=阐明
envelop=信封
envelope=信封
envious=羡慕
environ=环境
environment=环境
environmental=环境的
environmentalist=环保主义者
environs=周围环境
envisage=设想
envision=设想
envoy=使者
envy=嫉妒
enzyme=酶
epaulet=肩章
ephemeral=短暂的
epic=史诗
epicure=美食家
epicurean=享乐主义者
epideictic=流行性
epidemic=流行性
epidermis=表皮
epigram=警句
epilogue=结语
episode=插曲
episodic=情节性的
epistolary=书信体
epitaph=墓志铭
epithet=绰号
epitome=缩影
epitomize=缩影
epoch=时代
equable=平等
equal=平等的
equality=平等
equally=同样
equanimity=平等
equate=等同
equation=方程
equator=赤道
equestrian=马术
equilibrium=平衡
equine=马
equip=装备
equipment=设备
equitable=公平
equity=公平
equivalence=等价
equivalent=相等的
equivocal=模棱两可
equivocate=含糊其辞
equivocation=含糊其辞
era=时代
eradicate=根除
eradication=根除
erase=擦除
eraser=橡皮
erasure=擦除
erect=直立
erection=勃起
erode=侵蚀
erosion=侵蚀
erosive=侵蚀性的
err=犯错
errand=差事
erratic=不稳定
erroneous=错误
error=错误
ersatz=代用品
erstwhile=昔日
erudite=博学
erupt=爆发
eruption=喷发
escalate=升级
escalation=升级
escalator=自动扶梯
escape=逃脱
escapism=逃避主义
eschew=避开
escort=护送
esophagus=食管
esoteric=深奥的
especially=尤其
espionage=间谍
espousal=拥护
espouse=支持
espy=间谍
essay=散文
essayist=散文家
essence=本质
essential=基本的
establish=建立
establishment=建立
estate=财产
esteem=尊重
esthetic=审美的
esthetics=美学
estimable=可估计的
estimate=估计
estimation=估计
estrange=离间
estranged=疏远
estuary=河口
etch=蚀刻
etching=蚀刻
eternal=永恒
eternity=永恒
ethereal=空灵的
ethic=道德
ethics=伦理
ethnic=种族的
ethnology=民族学
ethos=精神
etiquette=礼仪
etymology=词源
eucalyptus=桉树
eugenic=优生学
eulogistic=颂扬的
eulogize=讴歌
eulogy=颂
euphemism=委婉语
euphonious=悦耳的
euphoria=欣快感
euro=欧元
evacuate=撤离
evacuation=疏散
evade=逃避
evaluate=评价
evaluation=评估
evanescent=昙花一现
evaporate=蒸发
evaporation=蒸发
evasion=逃避
evasive=回避
eve=前夕
even=甚至
even-tempered=性情温和
evenhanded=不偏不倚
evening=晚上
evenly=均匀地
event=事件
eventful=多事
eventual=最终
eventuality=可能性
eventually=最终
ever=曾经
everlasting=永恒
every=每一个
everybody=所有人
everyday=每天
everyone=每个人
everything=一切
everywhere=到处
evict=逐出
eviction=驱逐
evidence=证据
evident=明显
evil=邪恶的
evildoer=妖孽
evince=表明
eviscerate=剔除内脏
evocative=令人回味的
evoke=唤起
evolution=进化
evolutionary=进化的
evolve=发展
ewe=母羊
ewer=水壶
exacerbate=加剧
exact=精确的
exacting=严格
exactitude=准确性
exaggerate=夸大
exaggeration=夸张
exalt=高举
exaltation=提高
exalted=崇高的
exam=考试
examination=考试
examine=检查
examinee=考生
examiner=考官
example=例子
exasperate=恶化
excavate=挖掘
exceed=超过
exceedingly=非常
excel=擅长
excellence=卓越
excellent=出色的
except=除了
exception=例外
exceptionable=例外的
exceptional=例外
excerpt=摘抄
excess=过量的
excessive=过多的
exchange=交换
exchequer=国库
excise=消费税
excitability=兴奋性
excite=激发
excitement=激动
exciting=令人兴奋
exclaim=惊呼
exclamation=感叹
exclamatory=感叹的
exclude=排除
exclusion=排除
exclusive=独家的
excogitate=深思熟虑
excoriate=苛责
excrete=排泄
excruciate=极其痛苦
exculpate=开脱
excursion=游览
excursive=远足的
excuse=原谅
execrable=可恶的
execrate=诅咒
execration=念咒
execute=执行
execution=执行
executive=管理人员
exemplary=示范
exemplify=举例说明
exempt=豁免
exemption=豁免
exercise=锻炼
exert=发挥
exertion=用力
exhale=呼气
exhaust=排气
exhaustion=疲惫
exhaustive=详尽无遗
exhibit=展览
exhibition=展览
exhilarate=兴奋
exhilarating=令人振奋
exhilaration=兴奋
exhort=劝勉
exhume=发掘
exigent=紧急
exiguous=稀少的
exile=流亡
exist=存在
existence=存在
existent=存在
existential=存在主义
existing=现存的
exit=出口
exodus=出埃及记
exonerate=开脱
exorbitant=高昂
exorcise=傩
exotic=异国情调
expand=扩张
expansion=扩张
expansive=扩张的
expatiate=详述
expatriate=外籍人士
expect=预计
expectancy=期望
expectation=期待
expediency=权宜之计
expedient=权宜
expedite=加快
expedition=远征
expeditious=迅速的
expel=驱逐
expend=花费
expenditure=支出
expense=费用
expensive=昂贵的
experience=经验
experienced=有经验
experiment=实验
experimental=实验
expert=专家
expertise=专业知识
expiate=赎罪
expiation=赎罪
expiration=到期
expire=到期
explain=解释
explanation=解释
explanatory=解释性的
explicable=可解释的
explicate=阐明
explicit=明确的
explode=爆炸
exploit=开发
exploitation=开发
exploration=勘探
explore=探索
explosion=爆炸
explosive=爆炸物
exponent=指数
exponentially=指数地
export=出口
exportation=出口
expose=暴露
exposition=展览
expository=说明性的
expostulate=劝诫
exposure=接触
expound=阐述
express=表达
expression=表达
expressive=富有表现力
expressly=明确地
expressway=高速公路
expropriate=征用
expulsion=驱逐
expunge=删除
expurgate=删节
exquisite=精美的
extant=现存
extemporaneous=即席
extemporize=即兴发挥
extend=延长
extended=延长
extension=扩大
extensive=广泛的
extent=程度
extenuate=减轻
exterior=外部的
exterminate=殄
external=外部的
externalize=外化
extinct=灭绝
extinction=灭绝
extinguish=熄灭
extirpation=根除
extol=颂扬
extort=勒索
extra=额外的
extract=提炼
extraction=萃取
extradite=引渡
extraneous=无关的
extraordinary=非凡的
extrapolate=推断
extravagance=奢侈
extravagant=靡
extreme=极端
extremist=极端分子
extremity=末端
extricable=可解脱的
extricate=解脱
extrinsic=外在
extrovert=外向
extrude=拉伸
exuberance=繁荣
exuberant=旺盛
exude=流露出
exult=欢腾
exultant=眉飞色舞
eye=眼睛
eyebrow=眉
eyesight=视力
eyewitness=目击者
fable=寓言
fabric=织物
fabricate=制造
fabrication=制造
fabulous=极好的
facade=正面
face=脸
facet=方面
facetious=滑稽的
facial=面部的
facile=容易的
facilitate=促进
facilitation=促进
facilities=设施
facility=设施
facsimile=传真
fact=事实
faction=派
factious=派系的
factitious=人为的
factor=因素
factorable=可分解
factory=工厂
factotum=杂役
factual=事实
faculty=学院
fad=时尚
faddish=时髦的
fade=褪色
fag=同性恋
fahrenheit=华氏度
fail=失败
fail-safe=故障安全
failure=失败
faint=头晕的
fainthearted=胆怯的
fair=公平的
fair-minded=公正的
fairly=相当
fairy=仙女
faith=信仰
faithful=忠实
fake=伪造的
falcon=鹘
fall=落下
fallacious=谬误的
fallacy=谬论
fallibility=可错性
fallible=易犯错误
fallow=休耕
FALSE=FALSE
falsehood=谬误
falsify=伪造
falter=动摇
fame=名声
familiar=熟悉的
familiarise=熟悉
familiarity=熟悉
familiarize=熟悉
family=家庭
famine=饥荒
famish=挨饿
famous=著名的
fan=扇子
fanatic=狂热分子
fanaticism=狂热
fancied=幻想
fancy=想要
fanfare=大张旗鼓
fang=方
fantasia=幻想曲
fantastic=极好的
fantasy=幻想
far=远的
far-reaching=深远
farce=闹剧
fare=票价
farewell=告别
farm=农场
farmer=农民
farming=农业
farrow=法罗
farther=更远
fascia=筋膜
fascinate=吸引
fascinating=迷人
fascination=魅力
fascism=法西斯主义
fascist=法西斯
fashion=时尚
fashionable=时髦
fast=快速地
fasten=系
fastidious=挑剔
fastness=牢度
fat=胖的
fatal=致命的
fatalism=宿命论
fatality=死亡
fate=命运
fateful=命运多舛
father=父亲
fatherly=父亲般的
fathom=捉摸
fatidic=宿命论
fatigue=疲劳
fatten=催肥
fatuity=昏庸
fatuous=昏庸
faucet=龙头
fault=过错
faultfinder=挑剔者
faulty=有缺陷的
fauna=动物
favor=支持
favorable=有利
favored=受青睐
favorite=最喜欢的
favour=青睐
favourable=有利
favourite=最喜欢的
fawn=讨好
fax=传真
faze=法兹
fealty=忠诚
fear=害怕
fearful=可怕
feasibility=可行性
feasible=可行的
feast=盛宴
feat=壮举
feather=羽毛
feature=特征
febrile=发热
february=二月
feckless=无能的
fecundity=生育力
federal=联邦
federation=联邦
fee=费用
feeble=微弱
feed=喂养
feedback=反馈
feel=感觉
feeling=感觉
feign=假装
feigned=佯装
feint=佯攻
feisty=精力充沛
felicitate=祝贺
felicitous=幸福的
feline=猫科动物
fell=下跌
fellow=研究员
fellowship=奖学金
felon=重罪犯
felony=重罪
female=女性
feminine=女性化
feminism=女权主义
feminist=女权主义者
fence=栅栏
fencing=击剑
fender=挡泥板
feral=野性的
ferment=发酵
fermentation=发酵
fern=蕨类
ferocious=凶猛
ferret=雪貂
ferrous=含铁的
ferry=渡船
fertile=沃
fertiliser=肥料
fertility=生育能力
fertilize=施肥
fertilizer=肥料
fervent=热切
fervid=热情
fervor=热情
festal=节日
fester=溃烂
festival=节日
festive=喜庆的
fetch=拿来
fetching=获取
fetid=恶臭
fetish=恋物癖
fetter=束缚
fetus=胎儿
feud=世仇
feudal=封建
fever=发烧
feverish=发烧的
few=很少
fiasco=惨败
fiat=菲亚特
fiber=纤维
fibre=纤维
fibrous=纤维状
fickle=善变的
fiction=小说
fictional=虚构
fictitious=虚拟
fidelity=保真度
fidget=坐立不安
field=场地
fiend=恶魔
fierce=凶猛的
fifteen=十五
fifth=第五
fifty=五十
fig=如图
fight=斗争
figment=虚构
figurative=比喻
figure=数字
figurehead=傀儡
figurine=塑像
filament=灯丝
filch=偷窃
file=文件
filial=孝
filibuster=阻挠议事
filigree=花丝
filings=备案
fill=充满
fillet=鱼片
filling=填充
filly=小母马
film=电影
filter=筛选
filth=污秽
filthy=污秽
fin=鳍
finable=可罚款
finagle=骗术
final=最终的
finale=结局
finalise=完成
finalize=完成
finally=最后
finance=金融
financial=金融的
finch=雀科
find=寻找
finding=发现
fine=美好的
finery=服饰
finesse=技巧
finger=手指
fingerprint=指纹
finicky=挑剔
finish=结束
finite=有限
fire=火
firearm=火器
firebrand=火炬
firefly=萤火虫
fireman=消防队员
fireplace=壁炉
fireworks=烟花
firm=公司
first=第一的
firstly=首先
fiscal=财
fish=鱼
fisherman=渔夫
fishery=渔业
fishing=钓鱼
fishy=腥
fissile=裂变
fissure=裂缝
fist=拳头
fit=合身
fitful=断断续续
fitness=健康
fitting=配件
five=五
fix=使固定
fixate=固定
fixation=固定
fixed=固定的
fixture=固定装置
flabby=松弛
flaccid=松弛
flag=旗帜
flagellate=鞭毛虫
flagellum=鞭毛
flagging=标记
flaggy=弗拉吉
flagrant=明目张胆
flail=连枷
flair=天赋
flak=高射炮
flake=薄片
flamboyant=龙飞凤舞
flame=火焰
flammable=易燃
flange=法兰
flank=侧翼
flannel=绒布
flap=襟翼
flare=耀斑
flash=闪光
flask=烧瓶
flat=平坦的
flatcar=平板车
flatten=压平
flatter=奉承
flattery=奉承
flatulence=胀气
flatulent=胀气
flaunt=标榜
flaunty=炫耀
flavor=味道
flavoring=调味品
flavour=味道
flaw=缺陷
flawless=完美无瑕
flax=亚麻
flay=剥皮
fleck=斑点
fledge=羽翼丰满
fledgling=雏鸟
flee=逃跑
fleece=羊毛
fleet=舰队
fleeting=转瞬即逝
flesh=肉
flexibility=灵活性
flexible=灵活的
flick=轻弹
flicker=闪烁
flight=航班
flighty=轻浮
flimflam=胡扯
flimsy=脆弱的
flinch=退缩
fling=一扔
flint=燧石
flip=翻动
flippant=轻率的
flirt=调情
flirtation=调情
flit=掠过
float=漂浮
flock=群
flood=洪水
floodgate=闸
floor=地面
floppy=软盘
flora=弗洛拉
florescence=花期
florid=华丽的
flossy=弗洛西
flounder=比目鱼
flour=面粉
flourish=繁荣
flout=藐视
flow=流动
flower=花
flu=流感
fluctuate=波动
fluctuation=波动
fluency=流利度
fluent=流利
fluffy=蓬松的
fluid=体液
fluke=吸虫
flummox=惊讶
flunk=不及格
fluorescent=荧光
flush=冲洗
fluster=慌乱
flustered=心慌意乱
flutter=扑
fluvial=河流
flux=通量
fly=飞
foam=泡沫
focus=重点
fodder=饲料
foe=敌人
fog=多雾路段
foggy=有雾
foible=怪癖
foil=挫败
fold=折叠
folder=文件夹
foliage=叶子
folk=民间
folklore=民俗学
folksy=亲切
follow=跟随
following=下列的
folly=蠢事
foment=罨
fond=喜欢
fondle=挲
food=食物
foodstuff=食品
fool=傻子
foolish=愚蠢
foolproof=万无一失
foot=脚
football=足球
foothold=立足点
footle=脚趾
footprint=脚印
fop=弗普
foppish=浮华的
for=为了
forage=饲料
forager=觅食者
foray=尝试
forbearance=忍耐
forbid=禁止
forbidding=禁止
force=力量
forceful=有力
ford=福特
forebear=祖先
forebode=预示
forecast=预报
foreclose=取消赎回权
forefront=前沿
forehead=前额
foreign=外国的
foreigner=外国人
foreknowledge=预知
foremost=最重要的
forensic=法医
foreordain=注定
forerunner=先行者
foresee=预见
foreseeable=可预见的
foreshadow=预示
foreshorten=缩短
foresight=远见
forest=森林
forestall=垄断
forestry=林业
foretell=预言
forever=永远
foreword=前言
forfeit=丧失
forfeiture=没收
forge=锻造
forger=锻工
forgery=伪造
forget=忘记
forgetful=健忘
forgettable=容易被忘记
forgive=原谅
forgiving=宽容
forgo=放弃
fork=叉
forlorn=绝望
form=形式
formal=正式的
formality=形式
format=格式
formation=形成
formative=形成性的
former=以前的
formidable=强大
formula=公式
formulate=制定
formulation=配方
forsake=背叛
forswear=作伪证
fort=堡
forte=长处
forth=向前
forthcoming=即将推出
forthright=直率
fortification=筑城
fortify=巩固
fortitude=坚韧
fortnight=两星期
fortress=堡垒
fortuitous=偶然
fortunate=幸运
fortune=财富
forty=四十
forum=论坛
forward=向前
fosse=福斯
fossil=化石
fossilize=变成化石
foster=促进
foul=犯规
found=成立
foundation=基础
founder=创始人
founding=创始
fountain=喷泉
four=四
four-poster=四柱床
fourteen=十四
fowl=鸡
fox=狐狸
foyer=门厅
fracas=争吵
fraction=分数
fractional=分数
fractious=脾气暴躁
fracture=断裂
fragile=脆弱的
fragility=脆弱性
fragment=分段
fragmentary=零碎的
fragmentation=碎片化
fragrance=香味
fragrant=香
frail=脆弱
frame=框架
framework=框架
franchise=特许经营
frank=坦率
frantic=疯狂的
frantically=疯狂地
fraternal=兄弟
fraternity=兄弟会
fraud=欺诈罪
fraudulent=欺诈
fraught=充满危险
fray=磨损
freak=怪物
freckle=雀斑
free=自由的
freedom=自由
freelancer=自由职业者
freestanding=独立式
freeway=高速公路
freeze=冻结
freight=货运
frenetic=狂热的
frenzy=狂乱
frequency=频率
frequent=频繁
fresco=壁画
fresh=新鲜的
freshman=大一
fret=烦恼
fretwork=镂空
friable=易碎
friction=摩擦
friday=星期五
fridge=冰箱
friend=朋友
friendly=友好的
friendship=友谊
frieze=雕带
fright=惊吓
frighten=吓唬
frigid=寒冷
frigidity=性冷淡
fringe=边缘
frisk=搜查
frisky=活泼的
fritter=油炸食品
frivolous=轻浮
frog=青蛙
frolic=嬉闹
frolicsome=嬉闹的
from=从
frond=叶状体
front=正面
frontier=边境
frost=霜
frosty=冷淡的
frothy=泡沫状
frown=皱眉
frowzy=邋遢的
fructify=结实
frugal=节俭
fruit=水果
fruitful=卓有成效
fruition=成果
frumpy=邋遢的
frustrate=阻挠
frustrating=令人沮丧
frustration=挫折
fry=炒
fuck=他妈的
fuddle=灌醉
fuel=燃料
fulcrum=支点
fulfil=实现
fulfill=实现
fulfillment=履行
fulfilment=履行
full=满的
full-blown=全面
full-bodied=醇厚
full-fledged=成熟的
fulminate=雷酸盐
fulsome=过分的
fumble=摸索
fume=烟
fumigate=熏
fun=乐趣
function=功能
functional=功能
functionary=职能部门
fund=基金
fundamental=基本的
funding=资金
funeral=葬礼
funereal=葬礼
fungi=真菌
fungicide=杀菌剂
fungus=菌
funky=时髦的
funny=有趣的
fur=毛皮
furbish=修葺
furious=狂怒
furnace=炉
furnish=提供
furniture=家具
furor=轰动
furrow=畦
further=更远
furthermore=此外
furtive=鬼鬼祟祟
fury=愤怒
fuse=保险丝
fusillade=齐射
fusion=融合
fuss=大惊小怪
fussy=挑剔
fustian=粗斜纹棉布
fusty=发霉的
futile=徒劳的
futility=无用
future=未来
fuzzy=模糊
gab=瞎扯
gabble=数落
gabby=盖比
gadfly=虻
gadget=小工具
gadgetry=小玩意
gaffe=失言
gag=插科打诨
gaggle=鹅群
gaiety=欢乐
gain=获得
gainful=有利可图
gainsay=否定
gait=步态
galaxy=星系
gale=大风
gall=瘿
gallant=英勇
gallery=画廊
galley=厨房
gallon=加仑
gallop=驰骋
gallows=绞刑架
galvanize=镀锌
gamble=赌博
gambol=嬉戏
game=游戏
gamut=色域
gander=公鹅
gang=帮派
gangling=瘦长的
gangly=瘦长的
gangrene=坏疽
gangster=流氓
gangway=舷梯
gaol=监狱
gap=差距
gape=裂开
garage=车库
garb=外衣
garbage=垃圾
garble=断章取义
garbled=乱码
garden=花园
gardener=园丁
gardenia=栀子花
gardening=园艺
gargantuan=庞大的
gargoyle=石像鬼
garish=扎眼
garland=花环
garlic=蒜
garment=服装
garner=加纳
garnish=装饰
garret=阁楼
garrulity=喋喋不休
garrulous=贫嘴
gas=气体
gaseous=气态
gash=伤口
gasification=气化
gasoline=汽油
gasp=喘气
gastric=胃
gastritis=胃炎
gastronomy=美食
gate=门
gather=收集
gathering=采集
gauche=左派
gaucherie=笨拙
gaudy=华而不实
gauge=测量
gaunt=憔悴
gavel=木槌
gawky=笨拙的
gay=同性恋
gaze=目光
gazetteer=地名词典
gear=齿轮
gem=宝石
gemstone=宝石
gender=性别
gene=基因
genealogy=家谱
general=一般的
generalise=概括
generality=概论
generalize=概括
generally=一般来说
generate=产生
generation=一代
generator=发电机
generic=通用的
generosity=慷慨
generous=慷慨的
generously=慷慨地
genesis=起源
genetic=遗传
genetically=基因上
genetics=遗传学
genial=和蔼可亲
genius=天才
genome=基因组
genre=类型
genteel=文雅
gentility=文雅
gentle=温和的
gentleman=绅士
gentry=绅
genuflect=跪
genuine=真的
genus=属
geographic=地理
geographically=地理位置
geography=地理
geological=地质
geologically=地质上
geology=地质学
geometric=几何的
geometrically=几何地
geometrician=几何学家
geometry=几何学
germ=胚芽
germane=相关的
germicide=杀菌剂
germinate=发芽
gerontocracy=老人政治
gerontology=老年医学
gerrymander=不公正划分选区
gestate=孕育
gesticulate=指手画脚
gesture=手势
get=得到
geyser=喷泉
ghastly=阴森
ghost=鬼
giant=巨大的
gibe=嘲讽
giddy=头晕
gift=礼物
gifted=天才
gigantic=巨大
giggle=傻笑
gild=镀金
gimmick=手法
gin=杜松子酒
ginger=姜
gingerly=小心翼翼地
giraffe=长颈鹿
girder=梁
girdle=腰带
girl=女孩
girth=周长
gist=要旨
give=给
given=给定
glacial=冰川
glacier=冰川
glad=高兴的
glade=林间空地
gladiator=角斗士
glamor=魅力
glamorous=魅力十足
glamour=魅力
glamourous=魅力十足
glance=一瞥
gland=腺
glare=强光
glaring=耀眼的
glass=玻璃
glaze=釉
gleam=闪光
glean=收集
glee=高兴
gleeful=欣喜若狂
glib=油嘴滑舌
glide=滑行
glider=滑翔机
glimmer=微光
glimpse=一瞥
glisten=闪亮
glitch=毛刺
glitter=闪光
gloaming=黄昏
gloat=幸灾乐祸
global=全球的
globalise=全球化
globalize=全球化
globe=地球
gloom=愁云
gloomy=阴沉
glorify=赞美
glorious=辉煌
glory=荣耀
gloss=光泽
gloss-over=粉饰
glossary=词汇表
glossy=光滑
glove=手套
glow=辉光
glower=怒视
glowing=发光
glucose=葡萄糖
glue=胶水
glut=过剩
glutinous=糯
gluttonous=饕
gnarled=粗糙的
gnat=蚊蚋
gnaw=啃
gnawing=啃咬
gnome=侏儒
gnomic=格言的
go=去
goad=刺激
goal=目标
goat=山羊
gobble=狼吞虎咽
goblet=高脚杯
god=上帝
goggle=护目镜
gold=金子
goldbrick=金砖
golden=金的
golf=高尔夫球
gong=锣
good=好的
goodbye=再见
goodness=善良
goods=商品
goodwill=善意
goof=犯傻
goose=鹅
gorge=峡谷
gorgeous=华丽的
gorilla=大猩猩
gormandize=大快朵颐
gosling=高斯林
gospel=福音
gossamer=游丝
gossip=闲话
gothic=哥特
gouge=挖出
gourd=葫芦
gourmand=美食家
gourmet=美食
govern=治理
governance=治理
government=政府
governor=州长
gown=袍
grab=抓住
grace=优雅
graceful=优美
gracile=纤细的
gracious=亲切
gradation=层次
grade=年级
gradient=坡度
grading=等级
gradual=循序渐进
gradually=逐步地
graduate=毕业
graduated=毕业
graduation=毕业
graft=接枝
grain=粮食
gram=克
grammar=语法
grammatical=语法的
gramme=克
granary=粮仓
grand=盛大
grandchild=孙子
grandchildren=孙子
granddaughter=孙女
grandeur=宏伟
grandfather=祖父
grandiose=宏伟的
grandmother=祖母
grandparent=祖父母
grandson=孙子
grandstand=看台
granite=花岗岩
grant=授予
granted=的确
granular=粒状
granulate=颗粒化
granule=颗粒
grape=葡萄
graph=图形
graphic=形象的
graphically=图形地
graphite=石墨
grasp=抓牢
grasping=抓握
grass=草
grasshopper=蚱蜢
grassy=长满草的
grate=篦
grateful=感激的
gratification=满足
gratify=满足
grating=光栅
gratis=免费
gratitude=感激
gratuitous=无偿的
gratuity=小费
grave=严重
gravel=碎石
gravitate=引力
gravitation=引力
gravitational=引力
gravity=重力
gray=灰色的
graze=轻擦
grazing=放牧
grease=润滑脂
greasy=腻
great=伟大的
greed=贪婪
greedy=贪婪的
green=绿色的
greenhorn=新手
greenhouse=温室
greet=迎接
greeting=问候
gregarious=群居
gregariousness=合群性
grenade=手榴弹
grey=灰色的
grid=网格
gridiron=烤架
grief=悲伤
grievance=不满
grieve=悲伤
grieved=伤心
grievous=痛苦的
grill=炙烤
grim=严峻
grimace=鬼脸
grimly=严肃地
grin=咧嘴笑
grind=研磨
grip=紧握
gripe=抱怨
gripping=扣人心弦
grisly=可怕的
gristle=脆骨
grit=砂砾
groan=呻吟
grocer=杂货商
grocery=杂货店
groom=新郎
groove=槽
grope=摸索
gross=总的
grotesque=怪诞的
grotto=石窟
grouch=牢骚
grouchy=脾气暴躁
ground=地面
grounded=接地
group=团体
grouse=松鸡
grove=树林
grovel=拜倒
grow=生长
growl=咆哮
growth=生长
grudge=怨恨
grueling=严罚
gruesome=可怕的
gruff=粗暴
grumble=叽
grumpy=脾气暴躁
guarantee=保证
guard=警卫
guardian=监护人
guess=猜测
guest=客人
guffaw=哄笑
guidance=指导
guide=指导
guideline=指南
guile=诡计
guileless=朴实
guillotine=断头台
guilt=有罪
guilty=有罪的
guise=伪装
guitar=吉他
guitarist=吉他手
gulch=峡谷
gulf=海湾
gull=鸥
gullible=容易受骗
gully=沟壑
gulp=吞咽
gum=胶
gun=枪
guru=大师
gush=喷
gusher=喷油器
gust=阵风
gustation=味觉
gustatory=味觉的
gusto=热情
gut=肠道
gutless=没胆量
gutter=排水沟
guttle=格特尔
guy=家伙
guzzle=狂饮
gym=健身房
gymnasium=健身房
gynaecocracy=妇女统治
gyrate=旋转
habit=习惯
habitable=可居住
habitat=栖息地
habitual=习惯性的
habitually=习惯性地
habituate=习惯
hack=黑客
hacker=黑客
hackneyed=陈词滥调
haft=柄
haggard=枯槁
haggle=讨价还价
hail=冰雹
hair=头发
hairy=毛茸茸
halcyon=宁静
hale=黑尔
half=一半
halfhearted=心不在焉
halfway=半
hall=大厅
hallmark=标志
hallow=神圣
hallowed=神圣的
hallucination=幻觉
halo=光环
halt=停止
halting=停止
ham=火腿
hamburger=汉堡包
hammer=锤
hamper=阻碍
hamstring=腿筋
hand=手
handbook=手册
handful=少数
handicap=障碍
handicapped=残障人士
handicraft=手工业
handle=处理
handsome=英俊的
handwriting=手写
handy=便利
hang=悬挂
hangar=机库
hangdog=垂头丧气
hanker=渴望
hankering=渴望
haphazard=偶然
happen=发生
happily=愉快地
happiness=幸福
happy=快乐的
harangue=长篇大论
harass=骚扰
harassment=骚扰
harbinger=预兆
harbor=港口
harbour=港口
hard=难的
hardbitten=顽固的
harden=硬化
hardheaded=固执的
hardihood=坚韧
hardly=几乎没有
hardship=困难
hardware=硬件
hardy=哈代
harm=伤害
harmful=有害
harmless=无害
harmonious=和谐
harmony=和谐
harness=马具
harp=竖琴
harpsichord=大键琴
harridan=泼妇
harrow=耙
harrowing=令人痛心
harry=哈利
harsh=残酷的
harshly=严厉地
harvest=收成
hassle=麻烦
haste=匆忙
hasten=趋
hasty=仓促的
hat=帽子
hatch=孵化
hatchet=斧头
hate=恨
hateful=可恶
hatred=仇恨
haughty=傲慢
haul=运输
haunt=出没
hauteur=豪特尔
have=有
haven=避风港
havoc=浩劫
hawk=鹰
hawker=小贩
hawser=缆绳
hay=干草
hazard=冒险
hazardous=危险
haze=阴霾
hazy=朦胧
he=他
head=头
headache=头痛
heading=标题
headline=标题
headlong=一头扎进去
headmaster=校长
headmistress=女校长
headquarters=总部
headstrong=任性
headway=进展
heady=令人陶醉的
heal=愈合
healing=康复
health=健康
healthful=健康的
healthy=健康
heap=堆
hear=听到
hearing=听力
hearken=倾听
hearsay=传闻
heart=心
hearten=鼓舞
heartfelt=衷心
heartrending=令人心碎
hearty=爽朗
heat=热
heated=加热
heating=加热
heave=升腾
heaven=天堂
heavy=重的
heavy-handed=严厉的
heavy-handedness['hevi'hændidnis]=粗暴无礼['hevi'hændidnis]
heckle=质问
hectare=公顷
hectic=忙碌的
hector=赫克托
hedge=对冲
hedgehog=刺猬
hedonic=享乐的
hedonism=享乐主义
hedonist=享乐主义者
heed=注意
heedless=不顾一切
heel=脚跟
hegemony=霸权
height=高度
heighten=增高
heinous=令人发指
heir=继承人
heiress=女继承人
heirloom=传家宝
heirship=继承权
helicopter=直升机
heliotrope=鸡血石
hell=地狱
hello=你好
helm=舵
helmet=头盔
helot=希洛人
help=帮助
helpful=有帮助的
helpless=无助
helplessly=无奈地
helve=帮助
hem=下摆
hemisphere=半球
hemophilia=血友病
hemorrhage=出血
hemostat=止血钳
hen=母鸡
hence=因此
henceforth=今后
henpecked=怕老婆
hepatitis=肝炎
her=她
herald=先驱报
herb=草本植物
herbaceous=草本的
herbal=草药
herbicide=除草剂
herbivorous=草食性
herd=一群
herdsman=牧人
here=这里
hereby=特此
hereditary=遗传
heredity=遗传
heresy=异端
heretic=异教徒
heretical=异端的
heritage=遗产
hermetic=密闭
hermit=隐士
hero=英雄
heroic=英勇
heroin=海洛因
heroine=女主角
heroism=英雄主义
herpetologist=爬虫学家
hers=她的
herself=她自己
hesitant=犹豫不决
hesitate=犹豫
hesitation=犹豫
heterodox=异端
heterogeneous=异质
hew=槎
hexagon=六边形
heyday=鼎盛时期
hi=你好
hiatus=中断
hibernate=休眠
hibernation=冬眠
hide=隐藏
hidebound=墨守成规
hideous=可怕
hiding=隐藏
hie=嗨
hierarchical=层级结构
hierarchy=等级制度
hieratic=僧侣式的
hieroglyph=象形文字
hieroglyphic=象形文字的
high=高的
high-tech=高科技
highbrow=雅俗共赏
highlight=强调
highly=高度
highway=公路
hijack=劫持
hike=远足
hilarious=搞笑
hilarity=欢闹
hill=爬坡道
hilly=丘陵
hilt=刀柄
him=他
himself=他自己
hind=后
hinder=阻碍
hindrance=阻碍
hinge=合页
hint=暗示
hinterland=腹地
hip=时髦的
hippopotamus=河马
hire=聘请
hirsute=多毛的
his=他的
hiss=嘶
histology=组织学
historian=历史学家
historic=历史性
historical=历史
history=历史
histrionic=戏剧性的
hit=打
hitherto=迄今
hive=蜂巢
hoard=囤
hoarse=嘶哑
hoary=苍老
hoax=骗局
hobble=蹒跚
hobby=爱好
hockey=曲棍球
hodgepodge=大杂烩
hoe=锄
hoist=提升
hold=抓住
hole=洞
holiday=假期
holiness=圣洁
hollow=空洞的
holocaust=大屠杀
holograph=全息图
holster=枪套
holy=圣
homage=尊敬
home=家
homeland=家园
homeless=无家可归
homely=家常
homeostasis=体内平衡
homestead=家园
homework=家庭作业
homicide=杀人
homiletics=布道学
homily=布道
homing=归巢
hominid=类人猿
homo=同型人
homogeneity=同质性
homogeneous=均质的
homogenize=均质化
homograph=同形异义词
homosexual=同性恋
hone=磨练
honest=诚实的
honesty=诚实
honey=蜂蜜
honeymoon=蜜月
honor=荣誉
honorable=光荣的
honorarium=酬金
honorary=名誉
honour=荣誉
honourable=光荣的
honourary=名誉的
hoodwink=蒙蔽
hoof=蹄
hook=钩
hoop=箍
hop=跳
hope=希望
hopeful=充满希望
hopeless=绝望
horizon=地平线
horizontal=水平的
hormone=激素
horn=喇叭
horology=钟表学
horrendous=可怕的
horrible=可怕
horrific=可怕
horrify=惊吓
horror=恐怖
horse=马
horsepower=马力
hortative=劝诫的
horticulture=园艺
hose=软管
hospitable=好客
hospital=医院
hospitality=酒店业
hospitalize=住院
host=主持人
hostage=人质
hostess=女主人
hostile=敌对的
hostility=敌意
hot=热的
hotdog=热狗
hotel=酒店
hound=猎犬
hour=小时
hourly=每小时
house=房子
household=家庭
housewife=家庭主妇
housework=家务
housing=住房
hovel=小屋
hover=徘徊
how=如何
however=然而
howl=嗥
howler=吼叫者
hub=中心
hubbub=尘嚣
hubris=傲慢
huckster=骗子
huddle=乱堆
hue=色调
huffish=哈菲什
huffy=哈菲
hug=拥抱
huge=巨大的
hulk=绿巨人
hull=船体
hum=哼
human=人类
humane=人道
humanism=人道主义
humanist=人文主义者
humanitarian=人道主义
humanity=人类
humble=谦逊的
humbly=谦卑地
humdrum=乏味
humid=湿
humidity=湿度
humiliate=羞辱
humiliation=屈辱
humility=谦逊
hummingbird=蜂鸟
humor=幽默
humorous=幽默
humour=幽默
humourous=幽默的
hump=驼峰
hunch=直觉
hundred=百
hunger=饥饿
hungry=饥饿的
hunk=猛男
hunker=蹲伏
hunt=打猎
hunter=猎人
hunting=打猎
hurdle=栏
hurl=投
hurricane=飓风
hurriedly=匆匆
hurry=匆忙
hurt=伤害
hurtful=伤人的
hurtle=猛冲
husband=丈夫
husbandry=畜牧业
hush=安静
husk=壳
husky=沙哑
hustle=忙碌
hut=小屋
hybrid=杂交种
hydrant=消防栓
hydrate=水合物
hydrogen=氢
hydrothermal=热液
hygiene=卫生
hygienic=卫生
hymn=圣歌
hyperactivity=多动症
hyperbole=夸张
hypertension=高血压
hyphen=连字符
hypnotic=催眠
hypocrisy=虚伪
hypocrite=伪君子
hypocritical=虚伪
hypodermic=皮下注射
hypotenuse=斜边
hypothesis=假设
hypothesize=假设
hypothetical=假想
hysteria=歇斯底里
hysterical=歇斯底里的
i=我
ice=冰
ice-cream=冰淇淋
iceberg=冰山
icicle=冰柱
icing=糖霜
icon=图标
iconoclast=偶像破坏者
iconoclastic=反传统主义者
icy=冰冷
idea=主意
ideal=理想的
idealism=唯心主义
idealistic=理想主义
idealize=理想化
identical=完全相同的
identification=鉴别
identify=确认
identity=身份
ideological=思想
ideology=思想
idiocy=白痴
idiom=成语
idiomatic=惯用语
idiosyncrasy=特质
idiot=笨蛋
idiotic=愚蠢的
idle=闲置的
idly=闲着
idol=偶像
idolater=偶像崇拜者
idolatrize=偶像崇拜
idolize=崇拜
idyll=牧歌
idyllic=田园诗般的
if=如果
igneous=火成岩
ignite=点燃
ignition=点火
ignoble=卑鄙的
ignominious=可耻
ignominy=耻辱
ignorance=无知
ignorant=无知
ignore=忽略
ill=患病的
illegal=非法的
illegible=难以辨认
illegitimate=不合法
illiberal=不自由的
illicit=非法
illiteracy=文盲
illiterate=文盲
illness=疾病
illuminate=照亮
illuminati=光明会
illumination=照明
illusion=错觉
illusive=虚幻
illusory=虚幻
illustrate=阐明
illustration=插图
illustrative=说明性的
illustrious=杰出
image=图像
imaginary=假想
imagination=想像力
imaginative=富有想象力
imagine=想象
imaging=成像
imagist=意象派
imbecile=愚蠢的
imbibe=吸收
imbroglio=纠葛
imbue=灌输
imitate=模拟
imitation=模仿
imitative=模仿的
immaculate=完美无瑕
immanent=内在的
immature=不成熟
immediate=即时
immediately=立即地
immemorial=远古
immense=巨大
immensely=非常
immensity=巨大
immerse=沉浸
immersion=浸没
immigrant=移民
immigrate=移民
immigration=移民
imminent=迫在眉睫
immobile=不动
immolate=牺牲
immortal=不朽
immune=免疫
immunise=免疫
immunity=免疫
immunize=免疫
immure=免疫
immutable=不可变的
imp=小鬼
impact=影响
impair=妨害
impale=刺穿
impalpable=不可触及
impart=传授
impartial=公正
impasse=僵局
impassioned=充满激情
impassive=冷漠的
impatience=不耐烦
impatient=不耐烦
impeach=劾
impeccable=无可挑剔
impecunious=身无分文的
impede=阻碍
impediment=妨碍
impel=促使
impend=迫在眉睫
impending=即将来临
impenetrable=无法穿透
impenitent=不知悔改
imperative=至关重要的
imperial=帝国
imperialism=帝国主义
imperialist=帝国主义
imperil=威胁
imperious=专横
impermanent=无常
impermeability=不渗透性
impermeable=不透水
impersonal=非个人的
impersonate=模仿
impertinence=无礼
impertinent=无礼的
imperturbable=泰然自若
impervious=不透水的
impetuous=浮躁
impetus=动力
impinge=冲击
implant=注入
implausible=难以置信
implement=实施
implementation=执行
implicate=牵连
implication=含义
implicit=隐式
implode=爆破
implore=恳求
imply=意味着
impolitic=不明智的
imponderable=无法估量的
import=进口
importance=重要性
important=重要的
importation=输入
importune=纠缠
impose=强加
imposing=施加
imposition=征收
impossibility=不可能
impossible=不可能的
impostor=骗子
imposture=骗局
impotence=阳痿
impoverish=使贫困
imprecation=诅咒
imprecise=不精确
impregnable=坚不可摧
impresario=经理人
impress=留下深刻印象
impressed=印象深刻
impression=印象
impressionable=易受影响
impressionism=印象派
impressive=感人的
impressively=令人印象深刻地
imprint=印记
imprison=监禁
imprisonment=监禁
impromptu=即兴
impropriety=不当行为
improve=提升
improvement=改进
improvident=缺乏远见
improvise=凑合
improvised=即兴的
imprudent=不谨慎
impudent=厚颜无耻
impugn=抨击
impuissance=无能
impulse=冲动
impulsive=冲动
impunity=有罪不罚
impure=不纯
impurity=杂质
imputation=归责
impute=归咎
in=在
inactivate=停用
inactive=不活跃
inadvertence=疏忽
inadvertently=无意中
inalienable=不可剥夺
inane=虚
inanimate=无生命的
inanity=空虚
inappreciable=微不足道
inaugural=就职
inaugurate=就职
inauguration=就职典礼
inborn=先天
incandescence=白炽
incantation=咒语
incapacitate=使丧失行为能力
incarcerate=监禁
incarnate=体现
incendiary=煽动性的
incense=香
incentive=激励
inception=起源
incertitude=不确定性
incessant=不断
incessantly=不已
inch=英寸
inchoate=不成熟
incidence=发病率
incident=事件
incidental=偶然的
incidentally=顺便
incinerate=焚化
incipient=初期
incise=切开
incision=切口
incisive=尖锐
incisor=门牙
incite=煽动
inclement=恶劣
inclination=倾角
incline=倾斜
inclined=倾向
include=包括
including=包括
inclusion=包容性
inclusive=包容性
incogitant=未认清的
incoherent=不连贯
income=收入
incommensurate=不相称
incompatible=不相容
incompetent=无能
inconceivable=不可思议
incongruent=不一致
incongruity=不协调
incongruous=不协调的
inconsequential=无关紧要
inconspicuous=不显眼的
inconstancy=反复无常
incontrovertible=无可辩驳
inconvenient=不方便
incorporate=包含
incorporation=成立
incorporeal=无形的
incorrigibility=不可救药
incorrigible=不可救药
incorruptible=廉洁
increase=增加
increasingly=日益
incredible=极好的
incredibly=难以置信
incredulity=怀疑
increment=增量
incriminate=指控
incrustation=结壳
incubate=孵化
incubation=孵化
incubator=孵化器
incubus=梦魇
inculcate=灌输
inculpate=指责
incumbent=现任
incur=招致
incursion=侵入
indebted=负债累累
indecent=猥亵
indecipherable=难以理解
indecisive=优柔寡断
indeed=的确
indefatigable=不懈
indefinite=不定
indelible=不可磨灭
indemnify=赔偿
indemnity=赔款
indent=缩进
indenture=契约
independence=独立
independent=独立的
indeterminate=不定
index=指数
indicate=表明
indication=指示
indicative=指示性的
indicator=指标
indices=索引
indict=起诉
indictment=起诉书
indifference=漠不关心
indifferent=冷漠
indigence=贫困
indigenous=土著
indigent=贫困
indigestion=消化不良
indignant=愤怒
indignation=愤慨
indignity=侮辱
indispensability=不可或缺性
indispensable=必不可少
indite=提出
individual=个人
individualism=个人主义
indoctrinate=灌输
indolent=懒惰的
indomitable=不屈不挠
indoor=室内的
indoors=室内
indubitable=不容置疑
induce=诱导
inducement=诱导
induct=诱导
induction=就职
indulge=放纵
indulgence=放纵
indulgent=放纵的
indurate=硬结
industrial=工业的
industrialise=工业化
industrialize=工业化
industrious=勤劳
industry=行业
inebriate=醉醺醺
ineffable=无法形容
ineffaceable=不可磨灭
ineffectual=无效
inelasticity=缺乏弹性
ineligible=不符合资格
ineluctable=不可避免的
inept=无能
ineptitude=无能
inequity=不公平
inert=惰性
inertia=惯性
inevitable=不可避免的
inevitably=不可避免地
inexhaustible=取之不尽
inexorable=不可阻挡
inexpedient=不合时宜
inexpiable=无法弥补的
inexplicable=无法解释
infallible=绝对正确
infamous=臭名昭著
infancy=婴儿期
infant=婴儿
infantile=幼稚的
infantry=步兵
infatuate=迷恋
infatuated=痴迷
infatuation=痴情
infect=感染
infection=感染
infectious=传染性
infelicitous=不幸的
infelicity=不幸
infer=推断
inference=推理
inferior=下
inferiority=自卑
infernal=地狱
inferno=地狱
infest=感染
infiltrate=浸润
infinite=无限
infinitesimal=无穷小
infinitive=不定式
infinity=无穷大
infirm=体弱多病
inflame=发炎
inflamed=发炎
inflammation=炎
inflate=膨胀
inflation=通货膨胀
inflexible=不灵活
inflict=造成
infliction=施加
influence=影响
influential=有影响
influenza=流感
influx=涌入
inform=通知
informal=非正式
informant=告密者
information=信息
informative=信息丰富的
informed=知情
informer=告密者
infraction=违法
infrared=红外线的
infrastructure=基础设施
infringe=侵犯
infringement=侵权
infuriate=激怒
infuse=注入
ingenious=巧妙
ingenuity=独创性
ingenuous=巧妙的
ingest=摄取
ingestion=摄入
ingrained=根深蒂固
ingrate=忘恩负义
ingratiate=迎合
ingratiating=讨好
ingredient=成分
ingress=入口
ingénue=天真无邪
inhabit=栖息
inhabitant=居民
inhale=吸入
inherent=固有
inherit=继承
inheritance=遗产
inhibit=抑制
inhibition=抑制
inhibitor=抑制剂
inhumane=不人道
inimical=敌对的
inimitable=无比
iniquitous=不公正的
iniquity=罪孽
initial=最初的
initially=最初
initiate=发起
initiation=引发
initiative=倡议
inject=注入
injection=注射
injunction=禁令
injure=损伤
injurious=有害的
injury=受伤
ink=墨水
inkling=暗示
inland=内陆
inmate=囚犯
inn=客栈
innate=先天
inner=内
innocence=纯真
innocent=清白的
innocuous=无害
innovate=创新
innovation=创新
innovative=创新的
innuendo=影射
innumerable=无数
inoculate=接种
inordinate=过度
input=输入
inquire=查询
inquiry=询问
inquisitive=好奇
inroad=侵入
insane=疯狂的
insanity=疯狂
insatiable=贪得无厌
inscribe=题
inscription=题词
inscrutable=难以捉摸
insect=昆虫
insecticide=杀虫剂
insensate=无知觉的
insentient=无知觉的
insert=插入
insertion=插入
inside=里面
insider=内幕
insidious=阴险
insight=洞察力
insightful=有洞察力
insignia=徽章
insincerity=不真诚
insinuate=暗示
insipid=平淡
insist=坚持
insistence=坚持
insistent=坚持
insolate=晒
insolence=傲慢
insolent=傲慢
insoluble=不溶解
insolvency=破产
insomnia=失眠
insouciance=漫不经心
insouciant=漫不经心
inspect=检查
inspection=检查
inspector=检查员
inspiration=灵感
inspirational=鼓舞人心的
inspire=启发
inspired=受到启发
instal=安装
instalation=安装
install=安装
installation=安装
installment=分期付款
instalment=分期付款
instance=实例
instant=立即的
instantaneous=瞬间
instate=确立
instead=反而
instigate=唆
instill=灌输
instinct=本能
instinctive=本能的
institute=研究所
institution=机构
institutional=机构
institutionalized=制度化
instruct=指示
instruction=操作说明
instructive=具有指导意义
instructor=讲师
instrument=乐器
instrumental=器乐
instrumentalist=工具主义者
insubordinate=不服从
insubstantial=不实质的
insufferable=无法忍受
insufficient=不足的
insular=孤島
insularity=孤岛性
insulate=隔离
insulation=绝缘
insulator=绝缘子
insulin=胰岛素
insult=侮辱
insuperable=不可逾越
insurance=保险
insure=保证
insurgent=叛乱分子
insurrection=起义
intact=完好无损的
intake=摄入量
intangibility=无形性
intangible=无形的
integral=不可缺少的
integrate=整合
integration=一体化
integrity=正直
intellect=智力
intellectual=知识分子
intelligence=智力
intelligent=聪明的
intelligible=可理解的
intend=打算
intense=激烈的
intensify=强化
intensity=强度
intensive=密集的
intent=意图
intention=意图
intentional=故意
inter=跨国公司
interact=相互影响
interaction=相互作用
interactive=交互的
intercede=说情
intercept=截距
intercessor=代祷者
interchangeable=可互换
intercourse=交往
interdict=禁令
interdisciplinary=跨学科
interest=兴趣
interested=感兴趣的
interesting=有趣的
interfere=干扰
interference=干涉
interim=临时
interior=内部的
interject=插
interjection=欹
interlace=交错
interlard=因特拉德
interlock=联锁
interlocking=联锁
interlocutor=对话者
interlope=侵犯
interloper=闯入者
interlude=插曲
intermediary=中介
intermediate=中间的
interminable=永无休止
intermingle=混合
intermission=中场休息
intermittent=间歇性
intern=实习生
internal=内部的
international=国际的
internecine=内讧
internet=互联网
internship=实习
interplay=相互作用
interpolate=插
interpose=介入
interpret=解释
interpretation=解释
interpreter=解释器
interregnum=空位期
interrogate=审问
interrogation=审讯
interrogative=疑问
interrupt=打断
interruption=中断
intersect=相交
intersection=路口
intersperse=穿插
interstellar=星际穿越
interstice=空隙
intertwine=交织
interval=间隔
intervene=干预
intervention=干涉
interview=面试
interviewee=受访者
interviewer=采访者
interweave=交织
intestate=无遗嘱
intestine=肠
intimacy=亲密
intimate=亲密的
intimidate=威吓
intimidation=恐吓
into=进入
intoxicate=醉人
intoxication=醉酒
intractable=难以解决
intransigent=顽固不化
intrepid=强悍
intricacy=复杂
intricate=错综复杂
intrigue=阴谋
intriguing=有趣的
intrinsic=固有的
intrinsically=本质上
introduce=介绍
introduction=介绍
introductory=介绍性的
introspective=内省的
intrude=侵入
intruder=入侵者
intrusion=入侵
intuition=直觉
intuitive=直觉的
intumescence=膨胀
inundate=淹没
inure=适用
inured=受保
invade=入侵
invader=侵略者
invalid=无效的
invalidate=使无效
invaluable=无价
invariably=总是
invasion=入侵
invasive=侵入性
invective=谩骂
inveigh=痛骂
inveigle=诱骗
invent=发明
invention=发明
inventor=发明者
inventory=存货
inverse=逆
inversion=倒置
invert=倒置
invertebrate=无脊椎动物
invest=投资
investigate=调查
investigation=调查
investigator=研究者
investiture=授职
investment=投资
investor=投资者
inveterate=根深蒂固
invidious=令人反感的
invigilate=监考
invigorate=振兴
invigorating=振奋人心
inviolable=不可侵犯
invisible=无形的
invitation=邀请
invite=邀请
inviting=邀请
invocation=调用
invoice=发票
invoke=调用
involuntary=非自愿的
involve=涉及
involved=涉及
involvement=参与
invulnerable=无懈可击
inward=向内
iodine=碘
iota=伊奥塔
irascible=暴躁
irate=愤怒
ire=愤怒
iridescence=彩虹色
iridescent=彩虹色的
irk=恼火
irksome=令人厌烦
iron=铁
ironclad=铁甲
ironic=讽刺
ironical=讽刺的
ironically=讽刺的是
irony=讽刺
irradiate=照射
irradicable=无法根除
irrational=不合理的
irreconcilable=不可调和的
irredeemable=无法挽回
irreducible=不可约化
irregular=不规律的
irrelevant=不相关的
irremediable=无法挽救
irrepressible=无法抑制
irreproachable=无可指责
irresistible=无法抗拒
irresolute=徊
irrespective=不论
irreverent=不敬的
irrevocable=不可撤销
irrigate=灌溉
irrigation=灌溉
irritable=易怒
irritate=刺激
irritating=令人恼火
irritation=刺激
island=岛
isle=小岛
isolate=隔离
isolated=孤立
isolation=隔离
isotope=同位素
issue=问题
isthmus=地峡
it=它
item=物品
iterate=迭代
itinerant=流动者
itinerary=行程
its=它是
itself=本身
ivory=象牙
jab=戳
jabber=喋喋不休
jack=杰克
jacket=夹克
jade=玉
jaded=厌倦
jagged=锯齿状
jail=监狱
jam=果酱
jamb=门框
jamboree=盛大庆典
january=一月
jape=笑话
jar=罐
jargon=行话
jarring=刺耳的
jaundice=黄疸
jaundiced=黄疸
jaunt=短途旅行
jaunty=轻快的
jaw=颚
jazz=爵士乐
jealous=嫉妒的
jealousy=妒忌
jeans=牛仔裤
jeep=吉普车
jeer=嘲笑
jejune=幼稚的
jelly=果冻
jellyfish=海蜇
jeopardise=危害
jeopardize=危害
jeopardy=危險
jerk=混蛋
jest=笑话
jesting=开玩笑
jet=喷射
jetlag=时差
jettison=抛弃
jewel=宝石
jewellery=首饰
jewelry=珠宝
jibe=嘲讽
jigsaw=拼图
jingoism=沙文主义
jitters=紧张
job=工作
jockey=骑师
jocular=诙谐
jocund=欢乐的
jog=慢跑
join=加入
joint=联合的
joke=开玩笑
jolly=快活地
jolt=颠簸
josh=乔希
jostle=推挤
jot=记下
jounce=颠簸
journal=杂志
journalism=新闻业
journalist=记者
journey=旅行
jovial=快活的
joy=喜悦
joyful=快乐
joyous=欢乐
jubilant=喜庆
jubilation=欢腾
judge=法官
judgement=判断
judgment=判断
judicial=司法
judiciary=司法
judicious=明智的
judiciousness=明智
juggernaut=巨型怪物
juice=汁
juicy=多汁
july=七月
jumble=混乱
jump=跳
jumpy=紧张的
junction=交界处
juncture=契机
june=六月
jungle=丛林
junior=初级
junk=垃圾
jupiter=木星
jurisdiction=管辖权
jurisprudence=法理
juror=陪审员
jury=陪审团
just=只是
justice=正义
justifiable=正当的
justification=理由
justify=证明合法
justly=公正地
juvenile=少年
juxtapose=并列
kaleidoscope=万花筒
kaleidoscopic=万花筒般的
kangaroo=袋鼠
keen=敏锐的
keep=保持
ken=肯
kennel=狗窝
kernel=核心
kerosene=煤油
kettle=壶
key=钥匙
keyboard=键盘
kick=踢
kid=孩子
kidnap=绑架
kidney=肾
kill=杀
killjoy=基尔乔伊
kiln=窑
kilo=公斤
kilogram=公斤
kilogramme=公斤
kilometer=公里
kilometre=公里
kin=亲属
kind=种类
kindergarten=幼儿园
kindle=点燃
kindness=仁慈
kindred=亲属
kinetic=動能的
king=国王
kingdom=王国
kiosk=亭
kiss=吻
kit=成套工具
kitchen=厨房
kite=风筝
knack=诀窍
knave=恶棍
knead=揉
knee=膝盖
kneel=下跪
knife=刀
knight=骑士
knit=针织
knob=旋钮
knock=敲
knoll=小丘
knot=结
knotty=棘手
know=知道
know-how=知识
knowhow=知识
knowledge=知识
knowledgeable=知识渊博
kudos=荣誉
lab=实验室
label=标签
labile=不稳定
labor=劳动
laboratory=实验室
labored=辛苦
laborious=费力的
labour=劳动
labyrinth=迷宫
lace=蕾丝
lacerate=划破
laceration=裂伤
lachrymose=泪糖
lack=缺少
lackadaisical=懒散的
lackey=走狗
lackluster=黯淡无光
laconic=简洁
lactic=乳酸
lad=小伙子
ladder=梯子
ladle=勺子
lady=女士
lag=落后
laggard=落后者
lair=巢穴
laity=俗人
lake=湖
lamb=羊肉
lambaste=谴责
lame=瘸
lament=哀叹
lamentable=可悲的
laminate=层压板
lamp=灯
lampoon=讽刺
lance=槊
lancet=柳叶刀
land=土地
landfill=垃圾填埋场
landing=降落
landlady=房东
landlocked=内陆
landlord=房东
landmark=里程碑
landmass=陆地
landscape=景观
landslide=滑坡
lane=车道
language=语言
languid=慵懒的
languish=憔悴
languor=倦怠
lank=兰克
lap=圈
lapidary=宝石匠
lapse=失效
laptop=笔记本电脑
lard=猪油
larder=储藏室
large=大的
largely=很大程度上
largess=慷慨
largesse=慷慨
lark=云雀
larva=幼虫
laser=激光
lash=睫毛
lass=姑娘
lassitude=倦怠
lasso=套索
last=最后的
lasting=持久
lastly=最后
latch=闩锁
late=晚的
lately=最近
latency=延迟
latent=潜
later=之后
lateral=侧
lathe=车床
latin=拉丁
latitude=纬度
latter=后者
lattice=格子
laud=赞美
laudable=值得称赞
laugh=笑
laughter=笑声
launch=发射
laundry=洗衣店
laureate=获奖者
laurel=月桂树
lava=岩浆
lavatory=厕
lave=澡
lavish=奢侈的
law=法律
lawful=合法的
lawn=草地
lawsuit=诉讼
lawyer=律师
laxative=泻药
lay=躺着
layer=层
layman=外行
layoff=裁员
layout=布局
layover=中途停留
laziness=懒惰
lazy=懒惰的
leach=利奇
lead=带领
leader=领导者
leadership=领导
leading=领导
leaf=叶子
leaflet=传单
league=联盟
leak=泄露
leakage=泄漏
lean=倾斜
leap=飞跃
learn=学习
learned=学到了
learner=学习者
learning=学习
lease=租
leash=皮带
least=至少
leather=皮革
leave=离开
leaven=酵
lectern=讲台
lecture=演讲
lecturer=讲师
ledge=壁架
ledger=分类帐
leer=色眯眯
leery=谨慎的
leeward=背风
leeway=余地
left=左边
leftist=左派
leftover=剩下的
leg=腿
legacy=遗产
legal=合法的
legalise=合法化
legalize=合法化
legend=传奇
legendary=传奇
legerdemain=魔术
legible=清晰易读
legion=军团
legislate=立法
legislation=立法
legislative=立法
legislator=立法者
legislature=立法机关
legitimacy=合法性
legitimate=合法的
leisure=闲暇
leisureliness=悠闲
leisurely=悠闲
lemon=柠檬
lemonade=柠檬水
lend=借
length=长度
lengthy=冗长
leniency=宽大
lenient=宽容
lens=镜片
lesbian=女同性恋
lesion=病变
less=较少的
lesson=课
lest=免得
let=让
lethal=致命
lethargic=昏昏欲睡
lethargy=昏睡
letter=信
lettuce=莴苣
levee=堤坝
level=等级
levelheaded=头脑冷静
lever=杠杆
leverage=杠杆作用
levity=轻浮
levy=征收
lexical=词汇
lexicographer=词典编纂者
lexicon=詞匯
liability=责任
liable=容易
liaison=联络
liar=说谎者
libel=诽谤
libelous=诽谤
liberal=自由派
liberality=宽容
liberate=解放
liberation=解放
libertine=浪荡子
liberty=自由
libido=性欲
librarian=图书管理员
library=图书馆
libretto=唱词
licence=执照
license=执照
licensed=持牌
licentious=淫乱
lichen=地衣
licit=合法
lick=舔
lid=盖
lie=说谎
lien=留置权
lieutenant=中尉
life=生活
lift=举起
ligature=结扎
light=光
lighting=灯光
lightning=闪电
ligneous=木质的
like=喜欢
likelihood=可能性
likely=有可能
liken=比喻
likewise=同样地
lily=百合
limb=肢
limber=柔软剂
limbo=边缘地带
lime=酸橙
limelight=聚光灯
limerick=利默里克
limestone=石灰石
limit=限制
limitation=局限性
limited=有限的
limn=林
limousine=豪华轿车
limp=跛行
limpid=清澈的
line=线
lineage=血统
lineal=直系
lineaments=线纹
linear=线性
linen=亚麻布
liner=衬垫
linger=萦绕
lingual=语言
linguist=语言学家
linguistic=语言
linguistics=语言学
link=关联
linkage=连锁
linoleum=油布
lint=皮棉
lion=狮子
lioness=母狮
lionize=崇拜
lip=唇
lipid=脂质
lipstick=口红
liquefy=液化
liquid=液体
liquidate=清算
liquor=酒
lissome=轻盈
list=列表
listen=听
listener=听众
listless=蔫
liter=升
literacy=识字
literal=文字
literally=字面上地
literary=文学
literate=识字
literati=文人
literature=文学
lithe=轻盈
lithosphere=岩石圈
litigant=当事人
litigation=诉讼
litre=升
litter=垃圾
little=小的
littoral=沿海地区
live=居住
livelihood=生计
lively=热闹
liver=肝
livestock=家畜
livid=铁青
living=活的
living-room=客厅
lizard=蜥蜴
load=加载
loaf=面包
loam=壤土
loan=贷款
loath=不愿
loathe=厌恶
lobby=大厅
lobbyist=说客
lobe=叶
local=当地的
locale=区域设置
locality=地方
locally=本地
locate=定位
location=地点
lock=锁
locker=储物柜
locomotion=运动
locomotive=机车
locus=轨迹
locust=刺槐
locution=言辞
lode=矿脉
lodge=小屋
lodging=住宿
loft=阁楼
lofty=崇高的
log=日志
logic=逻辑
logical=逻辑
logistic=后勤
logistical=后勤
logistics=后勤
logjam=僵局
logo=标识
loiter=游荡
loll=哈哈
loneliness=孤独
lonely=孤独
long=长的
long-winded=冗长
longevity=长寿
longing=渴望
longitude=经度
longitudinal=纵向
look=看
loom=织布机
loon=懒人
loop=环形
loophole=漏洞
loose=松动的
loosen=松开
loot=抢劫
lope=洛普
lopsided=片面
loquacious=贫嘴
lord=主
lore=知识
lorry=货车
lose=失去
loss=损失
lot=很多
lotion=洗剂
lottery=彩票
loud=大声
loudly=高声
lounge=休息室
lout=粗鲁的人
loutish=粗鲁
love=爱
lovely=迷人的
lover=情人
low=低的
lowbred=低等血统
lower=降低
loyal=忠诚
loyalty=忠诚
lubricant=润滑剂
lubricate=润滑
lubrication=润滑
lubricious=润滑的
lucid=清醒的
luck=运气
lucky=幸运的
lucrative=有利可图
lucre=钱财
lucubrate=仔细思考
ludicrous=荒谬的
lug=凸耳
luggage=行李
lukewarm=温
lull=麻痹
lullaby=催眠曲
lumber=木材
lumberjack=樵夫
lumen=流明
luminary=名人
luminous=发光的
lump=块
lunar=月球
lunatic=疯子
lunch=午餐
luncheon=午餐
lung=肺
lurch=困境
lure=饵
lurid=耸人听闻
lurk=潜伏
luscious=甜美
lush=郁郁葱葱
lust=欲望
luster=光泽
lustrous=有光泽的
lusty=精力充沛
luxuriant=茂盛
luxurious=豪华
luxury=奢华
lymphatic=淋巴
lynch=林奇
lyric=歌词
lyrical=抒情的
macabre=令人毛骨悚然
macerate=浸软
machination=诡计
machine=机器
machinery=机械
mackintosh=雨衣
maculate=有斑点
maculated=有斑点
mad=疯狂的
madam=女士
madcap=疯狂
madden=马登
madrigal=牧歌
maelstrom=漩涡
maestro=大师
magazine=杂志
magenta=品红
magic=魔法
magical=神奇
magisterial=权威的
magistrate=地方法官
maglev=磁浮
magma=岩浆
magnanimity=海量
magnanimous=坦荡
magnate=巨头
magnesium=镁
magnet=磁铁
magnetic=磁的
magnificence=壮丽
magnificent=壮丽
magnify=放大
magniloquent=夸夸其谈
magnitude=震级
magpie=鹊
maid=女佣
maiden=少女
mail=邮件
maim=致残
main=主要的
mainland=大陆
mainstream=主流
maintain=维持
maintenance=维护
maize=玉米
majestic=雄伟
majesty=威严
major=主要的
majority=多数
make=制作
makeshift=临时的
makeup=化妆品
maladroit=笨拙的
malady=弊病
malaise=不适
malapropism=词语误用
malcontent=不满者
male=男性
malediction=诅咒
malefactor=罪犯
maleficent=玛琳菲西特
malevolent=恶毒的
malfeasance=渎职
malfunction=故障
malice=恶意
malicious=恶意的
malign=诽谤
malignant=恶性
malinger=装病者
mall=购物中心
malleable=可塑性
mallet=槌
malodor=恶臭
malpractice=弊端
mammal=哺乳动物
mammals=哺乳动物
mammoth=长毛象
man=男人
manacle=束缚
manage=管理
management=管理
manager=经理
managerial=管理
mandate=授权
mandatory=强制的
maneuver=演习
mangle=曼格尔
mangy=肮脏的
manhood=男子气概
mania=躁狂
manifest=显现
manifestation=表现
manifesto=宣言
manifold=歧管
manipulate=操纵
manipulation=操纵
manipulative=操纵性的
mankind=人类
manly=男子气概
manner=方式
mannered=彬彬有礼
manoeuvre=演习
mansion=大厦
mantle=地幔
manual=手动的
manufacture=生产
manufacturer=制造商
manumit=马努米特
manure=肥料
manuscript=手稿
many=许多
map=地图
maple=枫
mar=马尔
marathon=马拉松
maraud=劫掠
marble=大理石
marbled=大理石纹
march=行进
mare=母马
margarine=人造黄油
margin=利润
marginal=边缘
marine=海洋
mariner=水手
marionette=木偶
marital=婚姻
maritime=海上
mark=标记
marked=标记
market=市场
marketing=营销
maroon=栗色
marred=损坏
marriage=婚姻
marrow=骨髓
marry=结婚
marsh=沼泽
marshal=元帅
marsupial=有袋动物
martial=武术
martyr=烈士
martyrdom=殉道
marvel=奇迹
marvellous=奇妙
marvelous=奇妙
marxism=马克思主义
marxist=马克思主义者
masculine=男性
masculinity=男子气概
mash=捣碎
mask=面具
mason=石匠
masquerade=化装舞会
mass=大量的
massacre=屠杀
massage=按摩
massive=大量的
mast=桅杆
master=掌握
mastermind=主谋
masterpiece=杰作
mastery=精通
masticate=咀嚼
mat=垫
matador=斗牛士
match=匹配
matchless=无比
mate=伴侣
material=材料
materialise=实现
materialism=唯物主义
materialist=唯物主义者
materialize=实现
maternal=母系
maternity=孕产
math=数学
mathematical=数学
mathematics=数学
maths=数学
matriarchy=母系社会
matriculate=录取
matrix=矩阵
matte=哑光的
matter=事情
mattress=床垫
mature=成熟
maturity=到期
maudlin=感伤
maul=打伤
maunder=胡说
mauve=淡紫色
maven=maven
maverick=特立独行
mawkish=感伤的
maxim=格言
maximal=最大
maximise=最大化
maximize=最大化
maximum=最大限度
may=可能
maybe=或许
mayhem=混乱
mayor=市长
maze=迷宫
me=我
meadow=草地
meager=微薄
meal=一顿饭
mealy=米利
mean=意思是
meander=蜿蜒
meaning=意义
meaningful=有意义的
means=方法
meantime=与此同时
meanwhile=同时
measly=微不足道
measurable=可衡量
measure=措施
measured=测量
measurement=测量
meat=肉
meaty=肉质的
mechanic=机械
mechanical=机械的
mechanics=力学
mechanisation=机械化
mechanise=机械化
mechanism=机制
mechanist=机械论者
mechanization=机械化
mechanize=机械化
medal=勋章
meddle=插手
meddlesome=好事
media=媒体
mediate=调解
mediation=调解
mediator=调解人
medical=医疗的
medicare=医疗保险
medicate=用药
medication=药物
medicinal=药用
medicine=药品
medieval=中世纪
mediocre=平庸
mediocrity=平庸
meditate=幽思
meditation=冥想
meditative=冥想的
medium=中等的
medley=混合泳
meek=温顺
meet=见面
meeting=会议
megalomania=自大狂
melancholy=忧郁
meld=融合
mellifluous=悦耳的
melodic=旋律的
melodie=旋律
melodious=优美的
melodrama=情节剧
melody=旋律
melon=瓜
melt=熔化
melting=融化
member=成员
membership=会员资格
membrane=膜
memento=纪念
memo=备忘录
memoir=回忆录
memorandum=备忘录
memorial=纪念馆
memorise=记住
memorize=记住
memory=记忆
menace=威胁
mend=修补
mendacious=虚伪的
mendacity=谎言
mendicant=乞丐
menial=卑微的
mental=精神的
mentality=心理
menthol=薄荷醇
mention=提到
mentor=导师
menu=菜单
mercantile=商业
mercenary=雇佣兵
merchandise=商品
merchant=商人
merciful=仁慈
mercurial=水银的
mercury=汞
mercy=怜悯
mere=仅仅
merely=仅仅
meretricious=华而不实的
merge=合并
merger=合并
merit=优点
merited=值得
meritorious=功勋卓著
mermaid=美人鱼
merriment=欢乐
merry=快乐的
mesa=台面
mesh=网
mesmerism=催眠术
mesmerize=催眠
mess=混乱
message=信息
messenger=信使
messy=凌乱的
metabolic=代谢
metabolism=代谢
metal=金属
metallic=金属
metallurgy=冶金
metamorphose=变态
metaphor=隐喻
metaphorical=隐喻的
metaphysical=形而上学
metaphysics=形而上学
mete=测量
meteor=流星
meteoric=流星
meteorite=陨石
meteorology=气象
meter=仪表
methane=甲烷
method=方法
methodical=有条不紊
methodology=方法论
meticulous=细致
metre=仪表
metric=度量
metrical=韵律的
metro=地铁
metropolis=都会
metropolitan=大都会
mettle=气概
mettlesome=勇敢的
miasma=瘴气
microbe=微生物
microorganism=微生物
microphone=麦克风
microprocessor=微处理器
microscope=显微镜
microscopic=微观的
microwavable=可微波
microwave=微波
midday=正午
middle=中间
middle-class=中产阶级
midget=侏儒
midnight=午夜
midst=中间
midwife=助产士
mien=面
miff=米夫
might=可能
mighty=强大的
migrant=移民
migrate=迁移
migration=移民
migratory=迁徙的
mild=温和的
mile=英里
mileage=里程
milestone=里程碑
militancy=好战
militant=好战分子
military=军队
militia=民兵
milk=牛奶
milky=乳白色
mill=磨
millennium=千年
millimeter=毫米
millimetre=毫米
million=百万
millionaire=百万富翁
mime=哑剧
mimic=模仿
mimicry=模仿
minaret=尖塔
minatory=威胁性的
mince=剁碎
mind=头脑
mindset=心态
mine=矿
mineral=矿物
mingle=交融
miniature=微型
minimal=最小
minimise=最小化
minimize=最小化
minimum=最低限度
mining=矿业
minion=奴才
minister=部长
ministerial=部长级
ministry=部
minnow=桃花鱼
minor=次要的
minority=少数民族
mint=薄荷
minuet=小步舞曲
minus=减
minuscule=微小的
minute=分钟
minutes=分钟
minutia=细节
miracle=奇迹
miraculous=神奇
mirage=海市蜃楼
mire=泥沼
mirror=镜子
mirth=欢笑
misanthrope=厌世者
miscellany=杂项
mischievous=恶作剧
miscreant=恶棍
miser=吝啬鬼
miserable=悲惨的
miserly=吝啬的
misery=苦难
misfortune=不幸
misgiving=疑虑
mishap=不幸事件
misinform=误导
mislead=误导
misleading=误导
misnomer=用词不当
misperceive=误解
misrepresent=歪曲
misrepresentation['mis,reprizen'teiʃən]=误传['mis,reprizen'teiʃən]
miss=错过
misshapen=畸形的
missile=导弹
missing=丢失的
mission=使命
missionary=传教士
missive=信函
mist=薄雾
mistake=错误
mistaken=错误
mister=先生
mistimed=时机不对
mistral=米斯特拉尔
mistress=情妇
misty=蒙蒙
misunderstand=误解
misunderstanding=误解
mite=螨虫
mitigate=缓解
mitten=手套
mix=混合
mixer=混合器
mixture=混合物
mnemonics=助记符
moan=呻吟
moat=护城河
mobile=移动的
mobilise=动员
mobility=流动性
mobilize=动员
mock=嘲笑
mode=模式
model=模型
modeling=造型
modem=调制解调器
moderate=缓和
moderation=适度
moderator=主持人
modern=现代的
modernisation=现代化
modernise=现代化
modernization=现代化
modernize=现代化
modest=谦虚的
modesty=谦逊
modicum=少量
modification=修改
modifier=修饰符
modify=调整
modish=时髦的
modulate=调制
mogul=大亨
moist=潮湿
moisten=濡
moisture=水分
molar=磨牙
mold=模具
molding=成型
moldy=发霉
molecular=分子
molecule=分子
molest=骚扰
mollify=缓和
mollycoddle=溺爱
molt=蜕皮
molten=熔化的
mom=妈妈
moment=片刻
momentarily=暂时
momentary=瞬间
momentous=重大
momentum=势头
mommy=妈妈
monarch=君主
monarchy=君主制
monastery=修道院
monday=周一
monetary=货币
money=钱
mongrel=杂种
monitor=监视器
monkey=猴
monochromatic=单色
monochrome=单色
monocle=单片眼镜
monogamy=一夫一妻制
monograph=专著
monolithic=单片
monologue=独白
monomania=偏执狂
monopolise=独占
monopolize=独占
monopoly=垄断
monotone=单调
monotonous=单调
monotony=单调
monsoon=季风
monster=怪物
monstrous=滔天
montage=剪辑
month=月
monthly=每月
monument=纪念碑
monumental=巨大的
mood=情绪
moody=喜怒无常
moon=月亮
moor=泊
mop=拖把
mope=忧郁
moral=道德
morale=士气
moralistic=道德的
morality=道德
morass=沼泽
moratorium=暂停
morbid=病态的
mordant=媒染剂
more=更多的
moreover=而且
mores=习俗
moribund=垂死
morning=早晨
moron=白痴
morose=郁闷
morsel=一点
mortal=凡人
mortality=死亡
mortar=砂浆
mortgage=抵押
mortification=屈辱
mortify=羞辱
mortuary=太平间
mosaic=马赛克
mosque=清真寺
mosquito=蚊子
most=最多
mostly=大多
mote=微粒
motel=汽车旅馆
moth=蛾
mother=母亲
motherly=母性的
motif=主题
motile=能动的
motility=运动能力
motion=运动
motivate=激励
motivation=动机
motive=动机
motley=杂色的
motor=发动机
motorway=高速公路
mottle=斑点
mottled=斑驳
motto=座右铭
mould=模具
mouldy=发霉的
mount=山
mountain=山
mountainous=多山
mountebank=骗子
mounting=安装
mourn=哀悼
mournful=悲哀
mourning=丧
mouse=老鼠
mouth=嘴
mouthful=满口
move=移动
movement=移动
movie=电影
mow=刈
much=很多
muck=淤泥
mud=泥
muddle=混乱
muddy=浑
muffle=消音
muffled=低沉的
muffler=围巾
mug=马克杯
muggy=闷热
mulct=抢夺
mule=骡子
mulish=穆斯林
mull=仔细考虑
multifarious=五花八门
multilateral=多边
multiple=多种的
multiplication=乘法
multiplicity=多重性
multiply=乘
multitude=民众
mumble=咕哝
munch=咀嚼
mundane=平凡的
municipal=市政
municipality=直辖市
munificence=慷慨
munificent=优厚
muniments=文书
munition=弹药
mural=壁画
murder=谋杀
murderous=凶残的
murky=浑浊的
murmur=杂音
muscle=肌肉
muscular=肌肉发达
muse=沉思
museum=博物馆
mushroom=蘑菇
music=音乐
musical=音乐
musician=音乐家
musicologist=音乐家
musket=滑膛枪
musky=麝香
must=必须
muster=鼓起
musty=霉味
mutate=变异
mutation=突变
mute=沉默的
muted=静音
mutilate=残害
mutineer=叛乱者
mutinous=叛变的
mutter=咕哝
mutton=羊肉
mutual=相互的
muzzy=穆兹
my=我的
myopia=近视
myopic=近视
myriad=无数
myself=我
mysterious=神秘
mystery=神秘
mystic=神秘
myth=神话
mythical=神话
mythology=神话
nadir=最低点
nag=唠叨
nail=指甲
naive=幼稚的
naivety=天真
naked=裸
name=姓名
namely=即
nap=小睡
napkin=餐巾
narcissism=自恋
narcissist=自恋者
narcotic=麻醉药
narrate=叙事
narration=叙述
narrative=叙述
narrator=叙述者
narrow=狭窄的
narrowly=勉强
nasal=鼻腔
nascent=新生
nasty=可恶的
natal=纳塔尔
natation=民族
nation=国家
national=国家的
nationalism=民族主义
nationalist=民族主义者
nationality=国籍
nationwide=全国
native=本国的
natty=纳蒂
natural=自然的
naturalist=自然主义者
naturally=自然
nature=自然
naughty=淘气
nausea=恶心
nauseate=恶心
nautical=航海
naval=海军
navigate=导航
navigation=导航
navy=海军
naysay=不说
naysayer=反对者
near=靠近
nearby=附近
nearly=几乎
neat=整洁的
nebulous=朦胧的
necessarily=一定
necessary=必要的
necessitate=需要
necessitous=必需的
necessity=必要性
neck=脖子
necklace=项链
necropolis=墓地
nectar=花蜜
need=需要
needle=针
needlework=针线活
needy=需要
nefarious=邪恶
negate=否定
negation=否定
negative=消极的
neglect=忽视
neglectful=疏忽
negligence=疏忽
negligent=疏忽
negligible=微不足道
negotiable=可以商议
negotiate=谈判
negotiation=谈判
neighbor=邻居
neighborhood=邻里
neighbour=邻居
neighbourhood=邻里
neither=两者都不
nemesis=宿敌
neoclassical=新古典主义
neolithic=新石器时代
neologism=新词
neon=氖
neonate=新生儿
neophyte=新手
nephew=侄子
nephritis=肾炎
nepotism=裙带关系
nerve=神经
nervous=紧张的
nest=巢
nestle=雀巢
nestling=雏鸟
net=网
nethermost=最底层
nettle=荨麻
network=网络
networking=联网
neurology=神经病学
neurosis=神经症
neutral=中性的
neutralise=中和
neutrality=中立
neutralize=中和
neutron=中子
never=绝不
nevertheless=尽管如此
new=新的
news=消息
newsletter=通讯
newspaper=报纸
next=下一个
nexus=关系
nib=笔尖
nibble=蚕食
nice=好的
nicety=细致
niche=利基
nick=缺口
nickel=镍
nickname=昵称
nicotine=尼古丁
niece=侄女
nifty=漂亮
niggard=吝啬鬼
niggling=琐碎的
night=夜晚
nightly=每晚
nightmare=恶梦
nihilism=虚无主义
nil=零
nimble=灵活
nine=九
nineteen=十九
ninety=九十
ninth=第九
nip=掐
nippers=钳子
nipping=咬
nippy=冷酷
nitpick=挑剔
nitrogen=氮
no=不
nobility=贵族
noble=高贵
nobody=没人
nocturnal=夜
nod=点头
noise=噪音
noisome=令人讨厌的
noisy=嘈杂
nomad=游牧民族
nomadic=游牧的
nominal=名义上的
nominate=提名
nomination=提名
nominee=被提名人
nonchalance=漠不关心
nonchalant=漠不关心
noncommittal=不置可否
nonconformist=不墨守成规的人
none=没有任何
nonentity=无足轻重
nonesuch=绝无仅有
nonetheless=尽管如此
nonflammable=不易燃
nonpareil=无比
nonplus=困惑
nonporous=无孔
nonradioactive=非放射性
nonsense=废话
nonsensical=荒谬
nonthreatening=非威胁性
nonviable=不具生存能力
noodle=面条
noon=中午
noose=套索
nor=也不
norm=规范
normal=普通的
normalisation=正常化
normalise=正常化
normalization=正常化
normalize=正常化
normally=通常情况下
north=北
northeast=东北
northeastern=东北
northern=北方
northwest=西北
northwestern=西北
nose=鼻子
nostalgia=怀旧
nostrum=秘方
nosy=多管闲事
not=不是
notability=知名度
notable=值得注意的
notate=记录
notation=符号
notch=缺口
note=笔记
notebook=笔记本
noted=著名的
noteworthy=值得注意的
nothing=没有什么
notice=注意
noticeable=显
notification=通知
notify=通知
notion=概念
notional=名义的
notoriety=恶名
notorious=臭名昭著
notwithstanding=虽然
noun=名词
nourish=滋养
nourishment=营养
nova=新星
novel=小说
novelist=小说家
novelty=新奇
november=十一月
novice=新手
now=现在
nowadays=如今
nowhere=无处
noxious=有害的
nuance=细微差别
nubile=青春期
nuclear=核
nucleate=成核
nucleus=核
nude=裸体
nudge=轻推
nudity=裸露
nugatory=无效的
nuisance=滋扰
null=无效的
nullify=使无效
numb=麻木的
number=数字
numerical=数值
numerology=命理学
numerous=很多的
numinous=神圣的
numismatic=钱币学
numismatist=钱币学家
nuptial=婚礼
nurse=护士
nursery=苗圃
nurture=培育
nut=坚果
nutrient=养分
nutriment=营养素
nutrition=营养
nymph=若虫
o'clock=点
oafishness=愚笨
oak=橡木
oar=桨
oasis=绿洲
oath=誓言
oatmeal=麦片
obdurate=固执的
obedience=服从
obedient=听话
obeisance=敬拜
obelisk=方尖碑
obese=肥胖
obesity=肥胖
obey=服从
obfuscate=混淆
obituary=讣告
object=目的
objection=异议
objective=客观的
oblation=祭祀
obligation=义务
obligatory=义务的
oblige=有义务
obliged=有义务
obliging=乐于助人的
oblique=斜
obliterate=泯
oblivion=遗忘
oblivious=忘却的
obloquy=漫骂
obnoxious=令人讨厌
obscene=猥亵
obscenity=淫秽
obscure=朦胧
obscurity=朦胧
obsequious=低三下四
observance=遵守
observant=善于观察
observation=观察
observatory=天文台
observe=观察
observer=观察者
obsess=缠住
obsessed=痴迷
obsession=痴迷
obsessive=强迫性
obsolescent=过时的
obsolete=过时的
obstacle=障碍
obstinacy=固执
obstinate=顽固
obstreperous=吵闹的
obstruct=阻碍
obstruction=梗阻
obtain=获得
obtainable=可获得的
obtainment=获得
obtrude=突出
obtuse=钝
obverse=正面
obviate=避免
obvious=明显的
obviously=明显地
occasion=场合
occasional=偶然
occasionally=偶尔
occidental=西方的
occlude=遮挡
occult=神秘的
occupancy=占用
occupant=居住者
occupation=职业
occupational=职业
occupy=占据
occur=发生
occurrence=发生
ocean=海洋
oceanic=海洋的
oceanographer=海洋学家
october=十月
octogenarian=八十多岁
octopus=章鱼
ocular=眼部
odd=奇怪的
oddity=怪异
oddments=零碎
odds=赔率
ode=颂
odious=可憎的
odium=憎恨
odometer=里程表
odor=气味
odoriferous=有气味的
odorous=有气味
odour=气味
odyssey=奥德赛
of=的
off=离开
off-key=走调
offbeat=另类
offence=罪行
offence(offense)=罪行（罪行）
offend=得罪
offender=罪犯
offense=罪行
offensive=进攻
offer=提供
offering=奉献
offhand=即兴
office=办公室
officer=官
official=官方的
officious=多管闲事
offish=离鱼
offset=抵消
offspring=后代
offstage=舞台之外
often=经常
oftentimes=常常
ogle=眄
oil=油
oily=油腻的
ointment=软膏
okay=好的
old=老的
old-fashioned=老式的
oleaginous=油质的
olfaction=嗅觉
olfactory=嗅觉
oligarch=寡头
oligarchy=寡头政治
olive=橄榄
olympiad=奥林匹克运动会
olympic=奥林匹克
olympics=奥运会
omelet=煎蛋卷
ominous=不祥的
omission=省略
omit=忽略
omnipotent=无所不能
omnipresent=无所不在
omniscient=无所不知
omnivorous=杂食性
on=在
once=一次
one=一
onerous=繁重的
oneself=自己
ongoing=正在进行
onion=洋葱
online=在线的
only=仅有的
onset=发病
onslaught=猛攻
onto=到
onus=责任
onward=向前
ooze=软泥
opacity=不透明度
opal=蛋白石
opalescence=乳光
opaque=不透明
open=打开
opener=开场白
opening=开幕
openly=公然
opera=歌剧
operate=操作
operation=手术
operational=操作
operative=操作人员
operator=操作员
operetta=轻歌剧
opiate=鸦片
opine=表示意见
opinion=观点
opinionated=自以为是
opponent=对手
opportune=适时
opportunity=机会
oppose=反对
opposed=反对
opposite=对面的
opposition=反对
oppress=压迫
oppression=压迫
oppressive=压迫性的
opprobrious=可耻
opt=选择
optic=光学
optical=光学的
optimal=最佳的
optimism=乐观
optimist=乐天派
optimistic=乐观的
optimization=优化
optimum=最佳
option=选项
optional=选修的
opulence=丰裕
opulent=华丽的
opus=作品
or=或者
oracle=神谕
oracular=神谕的
oral=口服
orange=橙子
oration=致辞
oratorio=清唱剧
oratory=演说
orbit=轨道
orbital=轨道
orchard=果园
orchestra=乐队
orchid=兰花
ordain=任命
ordeal=考验
order=命令
orderly=秩序
ordinance=条例
ordinary=普通的
ordnance=军械
ore=矿石
organ=器官
organic=有机的
organisation=组织
organisational=组织
organise=组织
organism=生物
organization=组织
organizational=组织
organize=组织
orient=东方
oriental=东方
orientation=方向
orifice=孔
origin=起源
original=原来的
originality=独创性
originally=起初
originate=起源
ornament=装饰品
ornamental=装饰
ornate=华丽的
ornery=脾气暴躁
ornithologist=鸟类学家
ornithology=鸟类学
orotund=奥罗顿
orphan=孤儿
orphanage=孤儿院
orthodontics=正畸
orthodox=正统
oscillate=摆动
osmosis=渗透
osseous=骨质的
ossify=骨化
ostensible=表面上的
ostentation=炫耀
ostracism=排斥
ostracize=放逐
ostrich=鸵鸟
other=其他
other-directed=他人主导
otherwise=否则
otiose=闲置的
otter=獭
ought to=应该
ounce=盎司
our=我们的
ours=我们的
ourselves=我们自己
oust=驱逐
out=出去
outbreak=暴发
outcome=结果
outdated=过时的
outdoor=户外的
outdoors=户外
outer=外
outfit=全套服装
outfox=出类拔萃
outgas=排气
outgoing=传出
outgrowth=产物
outing=郊游
outlandish=古怪的
outlaw=取缔
outlet=出路
outline=大纲
outlook=前景
outmaneuver=智取胜
outmoded=陈旧
output=输出
outrage=暴行
outrageous=离谱
outrageously=令人愤慨地
outset=一开始
outshine=胜过
outside=外部
outsider=局外人
outskirts=郊区
outspoken=直言不讳
outstanding=杰出的
outstrip=超过
outward=向外
outwards=向外
outwit=智胜
oval=椭圆形
ovation=欢呼
oven=烤箱
over=超过
overall=全面的
overbearing=霸道
overcoat=大衣
overcome=克服
overdose=过量
overdue=逾期
overexposure=过度接触
overflow=溢出
overhaul=大修
overhead=开销
overhear=偷听
overlap=重叠
overlook=俯瞰
overnight=过夜
overpowering=压倒性的
overreach=过度扩张
override=覆盖
overriding=覆盖
overrule=否决
overseas=海外
oversee=监督
overshadow=遮蔽
oversight=监督
overstate=夸大
overt=公开
overtake=超过
overthrow=推翻
overtime=随着时间的推移
overture=序曲
overturn=颠覆
overweening=傲慢
overwhelm=压倒
overwhelming=压倒
overwhelmingly=压倒性地
overwrought=雕饰
owe=欠
owing to=由于
owl=猫头鹰
own=自己的
owner=所有者
ownership=所有权
ox=牛
oxide=氧化物
oxidize=氧化
oxygen=氧
oyster=牡蛎
ozone=臭氧
pace=步伐
pacifist=和平主义者
pacify=安抚
pack=盒
package=包裹
packed=已打包
packet=包
pact=协议
pad=软垫
padding=填充
paddle=桨
paddy=稻田
paean=赞歌
pagan=异教徒
page=页
pageant=盛会
pain=疼痛
painful=痛苦
painkiller=止痛药
painstaking=煞费苦心
paint=画
painter=画家
painting=绘画
pair=一对
palace=宫殿
palatable=可口的
palate=腭
palatial=富丽堂皇
palaver=闲谈
pale=苍白
paleolithic=旧石器时代
paleontology=古生物学
palette=调色板
palings=栅栏
pall=帕尔
palliate=缓解
palliative=姑息治疗
pallid=苍白
palm=棕榈
palmy=棕榈树
palpable=可触及的
palpitate=悸
palter=帕特
paltry=微不足道
pamper=宠爱
pamphlet=小册子
pan=平底锅
panacea=万能药
panache=风度
pancreas=胰腺
panda=熊猫
pandemic=大流行
pandemonium=一片混乱
pander=迎合
pane=窗格
panegyric=颂
panel=控制板
pang=庞
panic=恐慌
panorama=全景
panoramic=全景
pant=喘气
pantechnicon=泛泰克尼康
pantheon=万神殿
panther=豹
pantomime=哑剧
pantry=食品储藏室
pants=裤子
paper=纸
paperback=平装
papyrus=纸莎草纸
parable=寓言
parabola=抛物线
parachute=降落伞
parade=游行
paradigm=范例
paradise=天堂
paradox=悖论
paradoxical=矛盾的
paragon=模范
paragraph=段落
parallel=平行线
parallelism=并行性
paralyse=瘫痪
paralysis=麻痹
paralyze=使瘫痪
parameter=范围
paramount=派拉蒙
paranoia=偏执狂
paranoid=偏执狂
paraphrase=释义
parasite=寄生虫
parasitic=寄生
parcel=包裹
parch=胹
pardon=赦免
pare=削减
parent=父母
parental=父母
parenting=养育
pariah=贱民
parish=教区
parity=平价
park=公园
parka=派克大衣
parking=停車處
parlance=用语
parley=谈判
parliament=议会
parliamentary=议会
parlous=陧
parochial=教区的
parody=戏仿
parole=言语
paroxysm=发作
parquet=镶木地板
parrot=鹦鹉
parry=招架
parse=解析
parsimony=节俭
part=部分
partial=部分的
partiality=偏袒
partially=部分
participant=參與者
participate=参加
participation=参与
particle=粒子
particular=特别的
particularize=详述
particularly=特别
partisan=党派
partition=分割
partly=部分地
partner=伙伴
partnership=合伙
parturition=分娩
party=派对
pass=经过
passage=通道
passenger=乘客
passerby=过路人
passion=热情
passionate=热情的
passive=被动的
passport=护照
password=密码
past=过去的
pasta=面食
paste=粘贴
pastel=粉彩
pasteurize=巴氏灭菌
pastiche=模仿作品
pastime=消遣
pastor=牧师
pastoral=田园
pastry=糕点
pasture=牧场
pat=拍
patch=修补
patent=专利
path=小路
pathetic=可怜的
pathogen=病原
pathological=病理性的
pathology=病理
pathos=感伤
patience=耐心
patient=病人
patina=铜绿
patrician=贵族
patrimony=遗产
patriot=爱国者
patriotic=爱国
patriotism=爱国主义
patrol=巡逻
patron=赞助人
patronage=光顾
patronise=光顾
patronize=光顾
patronizing=居高临下
pattern=图案
paucity=缺乏
paunchy=大腹便便的
pauper=穷光蛋
pause=暂停
pave=铺平
pavement=路面
pavid=帕维德
paw=爪子
pawn=典当
pay=支付
payment=支付
payroll=工资单
pea=豌豆
peace=和平
peaceful=和平
peach=桃
peachy=桃色的
peak=顶峰
peaky=尖峰
peanut=花生
pear=梨
pearl=珍珠
peasant=农民
pebble=卵石
pecan=胡桃
peccadillo=小过失
peck=啄
peckish=馁
peculate=侵吞
peculiar=奇特
peculiarity=特点
pecuniary=金钱的
pedagogue=教育家
pedagogy=教育学
pedal=踏板
pedant=学究
peddle=兜售
pedestal=座
pedestrian=行人
pediatrics=儿科
peek=窥视
peel=果皮
peep=窥视
peer=对等体
peerless=绝世
peery=皮里
peeve=忿怒
peevish=脾气暴躁
peg=挂钩
pejorative=贬义
pelagic=远洋的
pelf=不义之财
pell-mell=乱七八糟
pellucid=透明的
pelt=毛皮
pen=笔
penal=刑事
penalise=惩罚
penalize=惩罚
penalty=惩罚
penance=忏悔
penchant=倾向
pencil=铅笔
pendant=吊坠
pendent=悬垂式
pending=待办的
pendulous=悬垂的
pendulum=摆
penetrate=穿透
penetration=渗透
penguin=企鹅
penicillin=青霉素
peninsula=半岛
penitent=忏悔者
pennant=三角旗
penny=一分钱
pension=养老金
pensioner=退休人员
pensive=沉思
penultimate=倒数第二
penumbra=半影
penury=贫困
people=人们
pepper=胡椒
peptic=消化性
per=每
perambulate=巡视
perceive=感知
percent=百分比
percentage=百分比
perception=洞察力
perceptive=有感知力的
perch=栖息
percolate=过滤
percussion=打击乐器
percussionist=打击乐手
peregrination=漫游
peremptory=蛮横
perennial=多年生
perfect=完美的
perfection=完美
perfervid=热情洋溢
perfidious=背信弃义
perfidy=背信弃义
perforate=穿孔
perform=履行
performance=表现
performer=演员
perfume=香水
perfunctorily=敷衍地
perfunctory=敷衍了事
perhaps=也许
perigee=近地点
peril=危险
perilous=危险的
perimeter=周长
period=时期
periodic=定期
periodical=期刊
peripatetic=巡游
peripheral=外围设备
periphery=周边
periphrastic=迂回曲折的
periscope=潜望镜
perish=沦
perishable=易腐烂
perishing=消亡
perjure=伪证
perjury=伪证
perk=振作
perky=活泼的
permanence=持久性
permanent=永恒的
permeable=透水
permeate=渗透
permeation=渗透
permissible=允许
permission=允许
permissive=宽容
permit=允许
pernicious=有害
perpendicular=垂直
perpetual=永久
perpetuate=延续
perplex=困扰
perplexity=困惑
perquisite=津贴
persecute=迫害
persecution=迫害
perseverance=毅力
persevere=坚持
persiflage=嘲讽
persist=坚持
persistence=持久性
persistent=执着的
persnickety=挑剔
person=人
personable=风度翩翩
personage=人士
personal=个人的
personality=性格
personally=亲自
personification=拟人化
personnel=人员
perspective=看法
perspicacious=敏锐的
perspicuity=明晰
perspicuous=清晰的
perspire=出汗
persuade=说服
persuasion=劝说
persuasive=有说服力
pertain=属于
pertinacious=固执的
pertinent=切题
peruse=细读
pervade=遍及
pervasive=普遍的
perverse=反常的
pervert=变态
pervious=透水
pesky=讨厌的
pessimism=悲观主义
pessimist=悲观主义者
pessimistic=悲观
pest=害虫
pester=纠缠
pesticide=农药
pestilent=有害的
pestle=杵
pet=宠物
petal=花瓣
petition=请愿
petitioner=请愿人
petrify=石化
petrochemical=石化
petroglyph=岩画
petrol=汽油
petroleum=石油
petrology=岩石学
pettish=脾气暴躁
petty=小气
petulance=性急
petulant=脾气暴躁
phantom=幻影
pharisaic=法利赛人
pharmaceutical=制药
pharmacology=药理
pharmacy=药店
phase=阶段
phenomena=现象
phenomenal=非凡的
phenomenon=现象
pheromone=信息素
phial=小瓶
philanthropic=慈善
philatelist=集邮爱好者
philately=集邮
philistine=庸俗
philology=语文学
philosopher=哲学家
philosophical=哲学的
philosophy=哲学
phlegmatic=冷静的
phobia=恐怖症
phoenix=凤凰
phone=电话
phonetic=语音的
phonetics=语音学
phony=假
photo=照片
photodissociation=光解离
photograph=照片
photographer=摄影师
photographic=摄影
photography=摄影
photorespiration=光呼吸
photosynthesis=光合作用
phrasal=短语
phrase=短语
physical=身体的
physician=医师
physicist=物理学家
physics=物理
physiological=生理
physiology=生理
pianist=钢琴家
piano=钢琴
piazza=广场
picayunish=皮卡尤尼什
pick=挑选
picky=挑剔的
picnic=野餐
pictorial=画报
picture=图片
picturesque=如画
piddling=微不足道
pie=馅饼
piebald=花斑
piece=片
piecemeal=零碎的
pied=皮耶德
pier=码头
pierce=刺穿
piercing=冲孔
pig=猪
pigeon=鸽子
pigment=颜料
pile=桩
pilfer=偷
pilferage=偷窃
pilgrim=朝圣
pilgrimage=朝圣
pill=丸
pillage=劫掠
pillar=支柱
pillory=颈手枷
pillow=枕头
pilot=飞行员
pin=别针
pincers=钳
pinch=捏
pine=松树
pink=粉色的
pinnacle=巅峰
pinpoint=查明
pint=品脱
pioneer=先锋
pious=虔诚的
pipe=管道
piquant=辛辣的
pique=皮克
piracy=海盗行为
pirate=海盗
pirouette=旋转
piscatorial=渔业的
pistol=手枪
pit=坑
pitch=沥青
pitcher=投手
piteous=可怜的
pitfall=陷阱
pith=髓
pithiness=简洁
pithy=精辟
pitiful=可怜
pitiless=无情
pittance=微薄的收入
pity=遗憾
pivot=枢
pivotal=关键的
pizza=比萨
placate=安抚
place=地方
placebo=安慰剂
placement=放置
placid=平静的
plagiarism=剽窃
plagiarize=抄袭
plague=瘟疫
plain=清楚的
plaintiff=原告
plaintive=哀怨
plait=编
plan=计划
plane=飞机
planet=行星
planetary=行星
plangent=哀鸣
plank=板
plankton=浮游生物
planner=规划师
planning=规划
plant=植物
plantation=种植园
plaque=牌匾
plaster=石膏
plastic=塑料
plate=盘子
plateau=高原
platform=平台
platitude=陈词滥调
platonic=柏拉图式的
plaudit=喝采
plausible=合理的
play=玩
player=玩家
playground=操场
playwright=剧作家
plaza=广场
plea=恳求
plead=恳求
pleasant=令人愉快的
please=请
pleasing=令人愉悦
pleasure=乐趣
pleat=褶裥
plebeian=平民
pledge=保证
plenary=全会
plenitude=丰富
plentiful=丰富
plentitude=充足
plenty=充足
pleonastic=重复的
plethora=过多
pliable=柔韧
pliant=柔顺的
pliers=钳
plight=困境
plinth=基座
plod=缓慢地
plot=阴谋
plough=犁
plow=犁
ploy=策略
pluck=采摘
plug=插头
plumb=垂直
plumber=水管工
plumbing=管道
plume=羽
plummet=直线下降
plump=丰满
plunder=掠夺
plunge=暴跌
plural=复数
plus=加
plush=豪华的
plutocracy=富豪
poach=偷猎
pocket=口袋
pod=荚
podcast=播客
podiatrist=足病医生
podium=领奖台
poem=诗
poet=诗人
poetic=诗意的
poetry=诗
poignant=凄美的
point=观点
pointed=尖
pointless=无意义
poise=平衡
poised=保持平衡
poison=毒
poisonous=有毒
poke=戳
polar=极性
polarity=极性
polarize=偏振
pole=极
polemic=辩论
polemical=辩论性的
police=警察
policeman=警察
policy=政策
polish=抛光
polite=有礼貌的
politeness=礼貌
political=政治的
politician=政治家
politics=政治
poll=轮询
pollen=花粉
pollinate=授粉
pollster=民意测验员
pollutant=污染物
pollute=污染
pollution=污染
poltroon=懦夫
polyandry=一妻多夫制
polyglot=多语种
polygon=多边形
polymath=博学者
polytechnic=理工学院
pomposity=华丽
pompous=浮夸的
poncho=雨披
pond=池塘
ponder=思考
ponderable=值得深思的
ponderous=沉重的
pontifical=教宗
pontificate=担任教皇
pony=小马
pool=水池
poor=贫穷的
pop=流行音乐
populace=民众
popular=受欢迎的
popularity=受欢迎程度
populate=填充
population=人口
populous=人口众多
porcelain=瓷
porch=门廊
porcine=猪
porcupine=豪猪
pore=毛孔
pork=猪肉
porous=多孔
porridge=稀饭
port=港口
portable=便携的
portend=预示着
portentous=不祥的
porter=搬运工
portfolio=文件夹
portion=部分
portrait=肖像
portray=写真
portrayal=描绘
pose=姿势
poseur=装腔作势者
posit=断定
position=位置
positive=积极的
positiveness=积极性
posse=团伙
possess=具有
possessed=拥有
possession=拥有
possessive=所有格
possibility=可能性
possible=可能的
possibly=可能
post=邮政
postage=邮资
postcard=明信片
poster=海报
posterior=后部
posterity=后人
postman=邮差
postpone=推迟
postponement=延期
postscript=后记
postulate=假定
posture=姿势
pot=锅
potable=饮用
potassium=钾
potation=一口
potato=土豆
potboiler=通俗作家
potent=有力的
potentate=君主
potential=潜在的
potentiality=潜力
potentiate=增强
potpourri=花香
potter=波特
pottery=陶器
poultry=家禽
pound=磅
pour=倒
pout=噘
poverty=贫困
powder=粉末
power=力量
powerful=强大的
practicable=切实可行的
practical=实际的
practicality=实用性
practically=几乎
practice=实践
practise=实践
practitioner=实践者
pragmatic=务实
prairie=草原
praise=称赞
prance=腾跃
prank=恶作剧
prate=闲聊
pray=祈祷
prayer=祷告
preach=传道
preacher=牧师
preamble=前言
precarious=岌岌可危
precaution=预防
precautionary=预防性的
precede=先行
precedent=先例
preceding=前
precept=戒律
precious=宝贵的
precipice=悬崖
precipitant=沉淀剂
precipitate=沉淀
precipitation=沉淀
precise=精确的
precisely=恰恰
precision=精确
preclude=排除
precocious=早熟
precursor=前体
predator=捕食者
predatory=掠夺性的
predecessor=前任
predestine=注定
predicament=困境
predict=预测
predictable=可预测
prediction=预言
predilection=偏好
predisposition=倾向
predominance=占主导地位
predominant=占主导地位
predominantly=主要
predominate=占主导地位
preeminent=卓越的
preempt=抢占
preen=打扮
preface=前言
prefer=更喜欢
preferable=可取的
preference=偏爱
preferential=优惠
prefigure=预示
pregnancy=怀孕
pregnant=孕
prehensile=善于抓握的
prehistoric=史前
prejudice=偏见
preliminary=初步的
preliterate=前文字
prelude=序幕
premature=过早
premeditate=考虑
premeditated=有预谋的
premier=总理
premiere=首映
premise=前提
premium=优质的
premonition=预感
preoccupation=全神贯注
preoccupied=全神贯注
preoccupy=全神贯注
preparation=准备
preparatory=预备
prepare=准备
preponderance=优势
preponderant=占主导地位
preponderate=占优势
preposition=介词
prepossessing=具有吸引力
preposterous=荒谬
prerequisite=先决条件
prerogative=特权
presage=预示
prescience=预知
prescribe=规定
prescription=处方
presence=在场
present=展示
presentation=推介会
presenter=主持人
presentiment=预感
presently=目前
preservation=保存
preservative=防腐剂
preserve=保存
preside=主持
presidency=总统任期
president=总统
presidential=总统
press=按
pressing=紧迫
pressure=压力
prestige=声望
prestigious=享有盛誉
presumable=可以推测
presumably=想必
presume=怙
presumption=假定
presumptuous=放肆
presupposition=前提
pretence=虚伪
pretend=假装
pretense=虚伪
pretension=自命不凡
pretentious=自命不凡
preternatural=超自然的
pretext=借口
pretty=漂亮的
prevail=占上风
prevailing=盛行
prevalence=患病率
prevalent=流行
prevaricate=搪塞
prevent=防止
prevention=预防
preventive=预防
preview=预览
previous=以前的
prevision=预知
prey=猎物
price=价格
priceless=无价
prick=刺
prickle=刺痛
pride=自豪
priest=牧师
prig=自命不凡的人
prim=原始
primal=原始的
primarily=主要
primary=基本的
primate=灵长类动物
prime=主要的
primitive=原始
primp=打扮
prince=王子
princess=公主
principal=主要的
principle=原则
print=打印
printer=打印机
printing=印刷
prior=事先的
priority=优先事项
prison=监狱
prisoner=囚犯
prissy=拘谨
pristine=原始的
privacy=隐私
private=私人的
privation=匮乏
privatisation=私有化
privatise=私有化
privatization=私有化
privatize=私有化
privilege=特权
privileged=特权
privy=知情的
prize=奖
probability=可能性
probable=可能
probably=大概
probe=探测
probity=廉洁
problem=问题
problematic=有问题的
proboscis=长鼻
procedure=程序
proceed=继续
proceedings=诉讼
proceeds=收益
process=过程
procession=游行
processor=处理器
proclaim=宣布
proclamation=公告
procrastinate=拖延
procreate=繁衍
procrustean=普罗克拉斯提斯
proctor=监考员
procure=采购
procurement=采购
prod=产品
prodigal=浪子
prodigious=惊人
prodigy=神童
produce=生产
product=产品
production=生产
productive=生产性
productivity=生产率
profane=亵渎
profess=宣称
profession=职业
professional=专业的
professor=教授
proffer=提供
proficiency=熟练程度
proficient=精通
profile=轮廓
profit=利润
profitable=有利可图
profiteer=奸商
profligate=挥霍无度
profound=深刻的
profoundly=深刻地
profuse=丰富的
progenitor=祖先
progeny=后代
prognosis=预后
prognosticate=预言
program=程序
programme=程序
progress=进步
progression=进展
progressive=进步
prohibit=禁止
prohibition=禁令
prohibitive=禁止的
prohibitively=禁止地
project=项目
projectile=射弹
projection=投影
projector=投影仪
proliferate=增生
prolific=多产
prolix=冗长
prolixity=罗唆
prologue=序幕
prolong=延长
prolonged=延长
promenade=长廊
prominence=突出
prominent=著名的
promise=承诺
promising=有希望
promote=推动
promotion=晋升
prompt=迅速的
promulgate=颁布
prone=易于
prong=叉
pronoun=代词
pronounce=发音
pronounced=发音
pronunciation=发音
proof=证明
proofread=校对
prop=支柱
propaganda=宣传
propagate=传播
propagation=传播
propel=推进
propeller=螺旋桨
propensity=倾向
proper=恰当的
property=财产
prophecy=预言
prophet=先知
prophetic=预言性的
propitiate=抚慰
propitious=吉祥
proponent=提倡者
proportion=部分
proportional=成比例的
proposal=提议
propose=提出
proposition=主张
proprietary=所有权
propriety=礼
propulsion=推进
prorogue=休会
prosaic=平淡的
proscenium=舞台前部
proscribe=禁止
prose=散文
prosecute=起诉
prosecution=起诉
proselytize=传教
prospect=前景
prospective=预期
prosper=繁荣
prosperity=繁荣
prosperous=繁荣
prostrate=匍匐
protagonist=主角
protean=变形虫
protect=保护
protection=保护
protective=保护的
protein=蛋白质
protest=反对
protocol=协议
prototype=原型
protract=拖延
protrude=突出
protuberance=凸起
protuberant=凸出的
proud=自豪的
prove=证明
provenance=出处
provender=饲料
proverb=谚语
proverbial=谚语
proverbially=俗话说
provide=提供
provided=假如
provident=有远见的
providential=天意
province=省
provincial=省级
provision=条款
provisional=临时
provisory=临时的
provocation=挑衅
provocative=挑衅
provoke=惹
prowess=实力
prowl=徘徊
proximate=近端
proximity=接近性
proxy=代理人
prude=假正经
prudence=谨慎
prudent=谨慎
prudish=拘谨
prune=修剪
pry=撬
précis=摘要
psalm=圣咏
pseudonym=笔名
psyche=精神
psychiatric=精神病的
psychiatrist=精神科医生
psychiatry=精神病学
psychoanalysis=精神分析
psychological=心理
psychologist=心理学家
psychology=心理学
pub=酒吧
puberty=青春期
public=民众
publication=发布
publicise=宣传
publicity=宣传
publicize=宣传
publicly=公开
publish=发布
pucker=皱褶
puckish=顽皮的
pudding=布丁
puddle=水坑
pudgy=矮胖的
pueblo=普韦布洛
puerile=幼稚
puffery=夸张
pugilism=拳击
pugilist=拳师
pugnacious=好斗的
puissance=力量
puissant=强大的
pulchritude=美丽
pull=拉
pullet=小母鸡
pulley=滑轮
pullulate=长出幼芽
pulp=纸浆
pulpit=讲坛
pulsate=搏动
pulsation=脉动
pulse=脉冲
pulverize=粉碎
pummel=揍
pump=泵
pumpkin=南瓜
pun=双关语
punch=冲床
punctilious=一丝不苟
punctual=准时
punctuality=准时
puncture=穿刺
pundit=权威人士
pungent=泼辣
punish=惩治
punishment=惩罚
puny=弱小
pupil=瞳孔
puppet=木偶
purblind=半盲
purchase=购买
pure=纯的
purgative=泻药
purgatory=炼狱
purge=清除
purify=净化
purity=纯度
purlieu=郊区
purloin=窃
purple=紫色的
purport=旨趣
purported=据称
purpose=目的
purposeful=有目的的
purse=钱包
pursue=追求
pursuit=追求
purvey=供应
push=推
pushy=咄咄逼人
pusillanimous=胆怯的
put=放
putative=假定的
putrefy=腐烂
putrid=腐烂的
putter=推杆
puzzle=谜
puzzlement=困惑
pygmy=侏儒
pylon=塔架
pyramid=金字塔
pyre=柴堆
pyromania=纵火狂
quack=嘎嘎
quadrangle=四边形
quadruped=四足动物
quaff=畅饮
quagmire=泥潭
quail=鹌鹑
quaint=古雅
quake=地震
qualification=资格
qualified=合格的
qualify=资格
qualitative=定性的
quality=质量
qualm=疑虑
qualms=疑虑
quandary=困惑
quantification=量化
quantify=量化
quantitative=定量
quantity=数量
quantum=量子
quarantine=隔离
quarrel=争吵
quarrelsome=吵架
quarry=采石场
quart=夸脱
quarter=四分之一
quarterly=季刊
quartet=四重奏
quartz=石英
quasar=类星体
quash=压制
quasi=准
quaver=颤声
quay=码头
queasy=恶心
queen=女王
queer=酷儿
quell=荡平
quench=淬火
querulous=抱怨的
query=询问
quest=寻求
question=问题
questionnaire=问卷
queue=队列
quibble=狡辩
quick=快的
quicksilver=水银
quiescent=静止的
quiet=安静的
quill=鹅毛笔
quilt=被子
quintessence=精髓
quip=讽刺
quirk=怪癖
quisling=卖国贼
quit=辞职
quite=相当
quiver=颤动
quixotic=不切实际的
quiz=测验
quondam=过去
quota=配额
quotation=引述
quote=引用
quotidian=日常的
rabbit=兔子
rabble=乌合之众
rabid=狂躁
rabies=狂犬病
race=种族
racial=种族
racing=赛车
racism=种族主义
racist=种族主义的
rack=架子
racket=球拍
racketeer=敲诈勒索者
raconteur=讲故事的人
racy=色情的
radar=雷达
radiant=光芒四射
radiate=辐射
radiation=辐射
radiator=散热器
radical=激进的
radio=收音机
radioactive=放射性
radioactivity=放射性
radius=半径
raffish=放荡不羁
raffle=抽奖
raft=筏
rafter=椽
rag=抹布
rage=愤怒
ragged=破烂
raggedly=破烂地
raging=愤怒
ragtime=拉格泰姆
raid=袭击
rail=轨
raillery=玩笑
railroad=铁路
railway=铁路
rain=雨
rainbow=彩虹
raincoat=雨衣
rainfall=雨量
rainy=下雨
raise=增加
raisin=葡萄干
rakish=放荡不羁
rally=集会
ram=内存
ramble=漫谈
rambunctious=喧闹的
ramify=分枝
ramp=坡道
rampage=狂暴
rampant=猖獗
rampart=壁垒
ramshackle=摇摇欲坠
ranch=牧场
rancid=馊
rancor=冤仇
random=随机的
range=范围
ranger=游侠
rank=秩
rankle=愤怒
ransom=赎金
rant=咆哮
rap=说唱
rapacious=贪婪
rape=强奸
rapid=迅速的
rapidity=快速性
rapids=急流
rapport=关系
rapprochement=和睦
rapscallion=恶棍
rapt=全神贯注
raptorial=猛禽
rapture=狂喜
rare=稀有的
rarefaction=稀疏
rarely=很少
rarity=稀有度
rascal=流氓
rash=皮疹
rashly=贸然
rasp=锉刀
raspy=刺耳的
rat=鼠
rate=速度
rather=相当
ratification=批准
ratify=批准
rating=等级
ratio=比率
ratiocination=推理
ration=配给
rational=合理的
rattle=嘎嘎作响
raucous=沙哑
ravage=蹂躏
rave=狂欢
ravel=拉威尔
ravening=贪婪
ravenous=贪婪的
ravine=山沟
ravish=蹂躏
ravishing=令人陶醉
raw=生的
ray=射线
rayon=人造丝
raze=夷
razor=剃刀
reach=抵达
react=反应
reactant=反应物
reaction=反应
reactionary=反动
read=读
reader=读者
readily=容易
reading=阅读
ready=准备好
reagent=试剂
real=真实的
realign=重新调整
realisation=实现
realise=意识到
realism=现实主义
realistic=实际的
reality=现实
realization=实现
realize=意识到
really=真的
realm=领域
ream=令
reap=收获
reaper=收割者
rear=后部
reason=原因
reasonable=合理的
reassurance=放心
reassure=安慰
rebarbative=令人厌恶的
rebate=回扣
rebel=反叛
rebellion=叛乱
rebellious=叛逆的
rebuff=回绝
rebuke=训斥
rebus=字谜
rebuttal=反驳
recalcitrant=顽固
recall=记起
recant=放弃
recantation=放弃信仰
recapitulate=概括
recast=重铸
recede=退却
receipt=收据
receive=收到
receiver=接收者
recent=最近的
recently=最近
receptacle=容器
reception=接待
receptionist=接待员
receptive=接受
receptor=受体
recess=休会
recession=经济衰退
recessive=隐性
recipe=食谱
recipient=接受者
reciprocal=互惠的
reciprocate=往复
recital=演奏会
recitation=背诵
recite=背诵
reckless=鲁莽
reckon=估计
reclaim=回收
recline=横卧
recluse=隐士
recognise=认出
recognition=认出
recognize=认出
recoil=畏缩
recollection=回忆
recombine=重组
recommend=推荐
recommendation=推荐
recompense=补偿
reconcile=调和
reconciliation=和解
reconciliatory=和解的
recondite=深奥的
reconnaissance=侦察
reconnoiter=侦察
reconstitute=重建
record=记录
recorder=录音机
recording=记录
recourse=追索权
recover=恢复
recovery=恢复
recreation=娱乐
recreational=休闲
recruit=招募
recruitment=招聘
rectangle=长方形
rectification=整改
rectify=纠正
rectitude=正直
recumbent=卧式
recuperate=疗养
recur=复发
recurrence=复发
recusant=拒绝者
recyclable=可回收
recycle=回收
red=红色的
reddish=微红色
redeem=赎回
redemptive=救赎
redirect=重定向
redistribution=重新分配
redolent=芳香的
redoubtable=令人敬畏的
redress=纠正
reduce=减少
reduction=减少
redundancy=冗余
redundant=多余的
reed=芦苇
reedy=芦苇
reef=礁
reek=恶臭
reel=卷轴
refectory=食堂
refer=参考
referee=裁判
reference=参考
referendum=公民投票
refine=精炼
refined=精制
refinement=细化
refinery=炼油厂
reflect=反映
reflection=反射
reflective=反光的
reform=改革
reformation=改革
reformist=改革派
refraction=折射
refractory=耐火
refrain=避免
refresh=刷新
refreshing=清爽
refreshment=茶点
refrigerate=冷藏
refrigeration=冷藏
refrigerator=冰箱
refuge=避难所
refugee=难民
refulgent=辉煌
refund=退款
refurbish=翻新
refusal=拒绝
refuse=拒绝
refutation=反驳
refute=反驳
regal=富丽堂皇
regale=款待
regard=看待
regarding=关于
regardless=不管
regenerate=再生
regent=摄政
regime=政权
regimen=方案
regiment=团
regimental=团
region=地区
regional=区域
register=登记
registrar=注册员
registration=登记
regress=回归
regressive=倒退的
regret=后悔
regretful=遗憾
regrettable=令人遗憾的
regular=常规的
regularity=规律性
regulate=调节
regulation=规定
regulator=调节器
regulatory=监管
rehabilitate=恢复
rehabilitation=康复
rehearsal=排演
rehearse=排练
reign=在位
reimburse=补偿
rein=缰绳
reincarnate=转世
reinforce=加强
reinforcement=加强
reinstate=恢复
reiterate=重申
reject=拒绝
rejection=拒绝
rejoice=麾
rejoicing=欣喜
rejoin=重新加入
rejoinder=反驳
rejuvenate=恢复活力
relapse=复发
relate=涉及
relation=关系
relationship=关系
relative=相对的
relatively=相对地
relativity=相对论
relax=放松
relaxation=松弛
relay=中继
release=发布
relegate=贬谪
relent=让步
relenting=让步
relentless=狠
relevance=关联
relevant=相关的
reliable=可靠的
reliance=依赖
relic=遗迹
relief=宽慰
relieve=缓解
relieved=松了一口气
religion=宗教
religious=宗教
relinquish=放弃
relish=津津乐道
reluctance=不情愿
reluctant=不情愿的
rely=依靠
remain=保持
remainder=余
remains=遗迹
remark=评论
remarkable=卓越
remedial=补救措施
remedy=补救
remember=记住
remembrance=纪念
remind=提醒
reminder=提醒
reminisce=回忆
reminiscence=怀旧
reminiscent=让人回味
remiss=疏忽
remission=缓解
remit=汇
remittance=汇款
remittent=滿意的
remnant=剩
remodel=改造
remonstrance=抗辩
remonstrate=抗议
remorse=悔恨
remote=偏僻的
removal=移动
remove=消除
remunerate=补偿
remunerative=有报酬的
renaissance=复兴
renascent=复兴
rend=撕裂
render=使成为
rendering=渲染
rendezvous=会合
rendition=引渡
renegade=叛徒
renege=食言
renew=更新
renewable=可再生
renewal=更新
renounce=放弃
renovate=翻新
renovation=翻新
renown=名声
renowned=著名的
rent=租
rental=租赁
renunciate=放弃
repair=维修
reparable=可修复
reparation=赔偿
repartee=妙语连珠
repatriate=撤侨
repay=偿还
repayment=还款
repeal=废除
repeat=重复
repeatedly=反复
repel=击退
repellent=驱蚊
repent=悔改
repercussion=反响
repertoire=曲目
repertory=剧目
repetition=重复
repetitive=重复
repine=抱怨
replace=代替
replacement=替代品
replenish=补充
replete=充足
replica=复制品
replicate=复制
reply=回复
report=报告
reportage=报告文学
reporter=记者
reportorial=報導的
repose=休息
repository=存储库
reprehend=谴责
reprehensible=应受谴责
represent=代表
representation=表示
representative=代表
repress=抑
repressed=被压抑
repression=抑制
repressive=镇压
reprieve=缓刑
reprimand=训诫
reprisal=报复
reprise=重演
reproach=责备
reprobate=堕落者
reproduce=复制
reproduction=生殖
reproductive=生殖
reproof=责备
reprove=责备
reptile=爬虫
reptilian=爬行动物
republic=共和国
republican=共和党人
repudiate=否认
repugnance=厌恶
repugnant=令人厌恶
repulse=击退
repulsion=排斥
repulsive=丑恶
reputable=信誉良好
reputation=名声
repute=名誉
request=要求
require=要求
requirement=要求
requisite=必需品
requite=报答
rescind=废除
rescission=撤销
rescript=诏书
rescue=救援
research=研究
researcher=研究员
resemblance=相似
resemble=类似
resent=怨恨
resentment=怨恨
reservation=预订
reserve=预订
reserved=预订的
reservoir=水库
reshuffle=改组
reside=居住
residence=住宅
resident=居民
residential=住宅
residual=残差
residue=残留物
resign=辞职
resignation=辞职
resigned=辞职
resilience=弹力
resilient=有弹性的
resin=树脂
resist=抵抗
resistance=反抗
resistant=抵抗的
resolute=坚决
resolution=解决
resolve=解决
resolved=已解决
resonance=谐振
resonant=共鸣
resort=采取
resound=回响
resource=资源
resourceful=足智多谋
respect=尊重
respectable=可敬
respectful=尊重的
respective=各自
respectively=分别
respiration=呼吸
respite=喘息
resplendent=灿烂
respond=回应
respondent=答辩人
response=回复
responsibility=责任
responsible=负责任的
responsive=响应式
responsiveness=响应能力
rest=休息
restaurant=餐厅
restitution=归还
restive=不安分的
restiveness=焦躁不安
restless=不安
restoration=恢复
restorative=修复性的
restore=恢复
restored=已恢复
restrain=抑制
restraint=克制
restrict=限制
restricted=受限制的
restriction=限制
restrictive=限制性的
result=结果
resultant=结果
resume=恢复
resumption=恢复
resurge=复苏
resurgence=再起
resurrect=复活
resuscitate=复苏
retail=零售
retailer=零售商
retain=保持
retainer=保持器
retaliate=报复
retaliation=报复
retard=减速
retarded=智力低下
retch=干呕
retell=复述
retelling=复述
retention=保留
retentive=记忆力
reticent=沉默寡言
reticulation=网状结构
retinue=随从
retire=退休
retired=退休
retirement=退休
retiring=退休
retort=反驳
retouch=修饰
retrace=回溯
retract=收回
retreat=撤退
retrench=裁员
retrenchment=裁员
retribution=报应
retrieval=检索
retrieve=取回
retroactive=追溯性
retrospect=回想
retrospective=回顾
return=返回
reunification=统一
reunion=团圆
reunite=团聚
reveal=揭示
revealing=揭露
revelation=启示
revelry=狂欢
revenge=复仇
revengeful=复仇的
revenue=收入
reverberate=回响
revere=尊敬
reverence=尊敬
reverie=遐想
reversal=逆转
reverse=撤销
reversible=可逆
reversion=反转
revert=恢复
review=审查
reviewer=审阅者
revile=唾骂
revise=修订
revision=修订
revitalize=振兴
revival=复兴
revive=复活
revoke=撤销
revolt=反叛
revolution=革命
revolutionary=革命性的
revolve=围绕
revue=评论
revulsion=厌恶
reward=报酬
rewarding=奖励
rhapsody=狂想曲
rhetoric=修辞
rhetorical=修辞的
rhinestone=水钻
rhinoceros=犀牛
rhubarb=大黄
rhyme=韵
rhythm=韵律
rhythmic=有节奏的
rib=肋骨
ribald=粗俗的
ribbon=丝带
rice=米
rich=富有的
rickety=摇摇晃晃
rid=摆脱
riddle=谜语
ride=骑
rider=骑士
ridge=岭
ridicule=嘲笑
ridiculous=荒谬的
rife=盛行
riffle=步枪
riffraff=痞子
rifle=步枪
rift=裂痕
rig=賭場
right=正确的
rigid=死板的
rigidity=刚性
rigmarole=废话
rigor=严格
rigorous=严格的
rigour=严格
rile=激怒
rim=轮缘
rind=果皮
ring=戒指
ringlet=卷发
rinse=冲洗
riot=暴动
riotous=喧闹
rip=撕开
ripe=成熟
ripen=熟
ripple=波纹
rise=上升
risk=风险
risky=有风险
rite=仪式
ritual=仪式
ritzy=豪华
rival=竞争对手
rivalry=对抗
rive=河流
riven=裂痕
river=河
rivet=铆钉
riveting=铆
rivulet=溪流
road=路
roam=漫游
roar=吼
roast=烤
rob=抢
robbery=抢劫
robe=长袍
robot=机器人
robotic=机器人
robust=强壮的
rock=岩石
rocket=火箭
rocky=岩石
rod=杆
rodent=啮齿动物
rodeo=牛仔竞技表演
roe=鱼子
roil=骚动
roister=喧闹
role=角色
roll=卷
roller=滚筒
rollicking=喧闹
romance=浪漫
romantic=浪漫的
roof=屋顶
rookie=新手
room=房间
root=根
rope=绳索
rose=玫瑰
roster=名册
rostrum=主席台
rosy=红润
rot=腐烂
rotate=旋转
rotation=旋转
rote=死记硬背
rotten=烂
rotund=圆润的
rough=粗糙的
roughen=使粗糙
roughly=大致
round=圆形的
roundabout=迂回
rouse=唤醒
rout=溃败
route=路线
routine=常规
rove=罗夫
row=排
rowdy=吵闹的
royal=皇家
royalty=皇室
rub=擦
rubber=橡皮
rubbish=垃圾
rubble=瓦砾
rubicund=红润的
ruck=拉克
rucksack=背包
rudder=舵
ruddy=红润
rude=粗鲁的
rudimentary=初级的
rue=后悔
ruffian=痞子
ruffle=褶边
rug=小地毯
rugged=崎岖
ruin=废墟
ruinous=毁灭性的
rule=规则
ruler=统治者
ruling=裁决
rumble=隆隆
ruminant=反刍动物
ruminate=寻味
rumor=谣言
rumour=谣言
rumple=皱巴巴的
run=跑步
rung=梯级
runic=符文
runner=跑步者
running=跑步
runway=跑道
rupture=破裂
rural=乡村的
ruse=诡计
rush=匆忙
rust=锈
rustic=乡村
rustle=沙沙
rustler=偷牛贼
rusty=生锈的
ruthless=无情
ruthlessness=冷酷无情
résumé=恢复
sabotage=破坏
saboteur=破坏者
sac=囊
saccharin=糖精
saccharine=糖精
sack=解雇
sacrament=圣餐
sacred=神圣
sacrifice=牺牲
sacrificial=牺牲的
sacrilege=亵渎
sacrilegious=亵渎神明
sad=伤心
sadden=悲伤
saddle=鞍
sadistic=虐待狂
sadness=悲伤
safe=安全的
safeguard=保障
safety=安全
sag=下垂
saga=传奇
sagacious=明智
sage=圣人
sail=帆
sailing=帆船
sailor=水手
saint=圣
saintly=圣洁的
sake=清酒
salad=沙拉
salamander=蝾
salary=薪水
sale=销售
salesman=推销员
salient=突出
saliferous=含盐
saliva=唾液
sallow=蜡黄的
sally=莎莉
salmon=三文鱼
salon=沙龙
salt=盐
salty=咸
salubrious=有益健康的
salutary=有益的
salutation=致敬
salute=礼炮
salvage=打捞
salvation=救恩
salve=药膏
same=相同的
sample=样本
sampler=采样器
sanatorium=疗养院
sanctify=圣化
sanctimonious=道貌岸然
sanction=制裁
sanctuary=避难所
sand=沙
sandal=檀香
sandwich=三明治
sane=理智的
sangfroid=冷静
sanguine=乐观
sanitary=卫生
sanitation=卫生
sanitize=消毒
sanity=理智
sap=树液
sapient=有智慧的
sapling=树苗
sapphire=蓝宝石
sarcasm=讽刺
sarcastic=讽刺的
sardonic=讽刺的
sartorial=服装
sash=窗扇
satanic=撒旦教
sate=状态
sated=饱足
satellite=卫星
satiate=饱足
satiated=饱足
satiny=缎子状
satire=讽刺
satiric=讽刺的
satirical=讽刺的
satirist=讽刺作家
satirize=讽刺
satisfaction=满意
satisfactory=令人满意的
satisfy=满足
saturate=饱和
saturated=饱和
saturation=饱和
saturday=周六
saturn=土星
saturnine=阴郁的
sauce=酱
saucy=无礼的
saunter=溜达
sausage=香肠
savage=野蛮的
savant=学者
save=节省
saving=保存
savings=储蓄
savor=品尝
savvy=精明
sawdust=锯末
say=说
saying=说
scab=痂
scabbard=刀鞘
scabrous=粗糙的
scad=鲻鱼
scads=很多
scaffold=脚手架
scald=烫伤
scalding=烫
scale=规模
scalpel=解剖刀
scamp=恶棍
scamper=疾走
scan=扫描
scandal=丑闻
scandalous=丑闻
scanner=扫描器
scant=稀少
scanty=稀少
scar=瘢痕
scarce=稀缺
scarcely=几乎
scarcity=缺乏
scare=吓
scarf=围巾
scarp=陡崖
scary=可怕的
scathe=伤害
scathing=严厉的
scatter=分散
scavenger=清道夫
scenario=设想
scene=场景
scenery=风景
scenic=风景
scent=香味
sceptic=怀疑论者
sceptical=持怀疑态度
scepticism=怀疑论
schedule=日程
schematic=示意图
schematize=图解
scheme=方案
schism=分裂
scholar=学者
scholarly=学术的
scholarship=奖学金
scholastic=学术的
school=学校
schooling=学校教育
science=科学
scientific=科学
scientist=科学家
scintillate=闪烁
scion=接穗
scission=分裂
scissor=剪刀
scissors=剪刀
scoff=嘲笑
scold=骂
scoop=舀
scooter=小型摩托车
scope=范围
scorch=烧焦
scorching=灼热
score=分数
scorn=轻蔑
scornful=轻蔑的
scorpion=蝎
scotch=苏格兰威士忌
scour=冲刷
scourge=祸害
scout=侦察
scowl=皱眉头
scraggly=蓬乱的
scramble=争夺
scrap=废料
scrape=刮
scrappy=好斗的
scratch=划痕
scrawl=乱涂
scream=尖叫
screed=砂浆层
screen=屏幕
screw=拧紧
screwdriver=螺丝刀
scribble=涂
scrimp=撙
script=脚本
scripture=圣经
scroll=滚动
scrub=擦洗
scruffy=邋遢的
scrumptious=美味可口
scruple=顾忌
scrupulous=一丝不苟
scrutable=可审查的
scrutinise=仔细审查
scrutinize=仔细检查
scrutiny=审查
scuba=水肺
scud=飞毛腿
scuff=磨损
sculpt=塑造
sculptor=雕塑家
sculpture=雕塑
scurrilous=粗俗的
scurry=疾走
scurvy=坏血病
scutter=斯卡特
scuttle=凿沉
scythe=镰
sea=海
seafaring=航海
seal=海豹
seam=接缝
seamy=阴暗的
sear=灼烧
search=搜索
season=季节
seasonal=季节性
seasoned=经验丰富的
seasoning=调料
seat=座位
secede=脱离
seclude=隔离
seclusion=隔离
second=第二
second-hand=二手
secondary=次要的
secrecy=保密
secret=秘密
secretarial=秘书
secretary=秘书
secrete=分泌
secretion=分泌
secretive=秘密的
sect=教派
section=部分
sector=部门
secular=世俗
secure=安全的
securities=证券
security=安全
sedate=稳重
sedative=镇静剂
sedentary=久坐
sediment=沉淀
sedition=煽动叛乱
seditious=煽动叛乱的
seduce=勾引
seduction=诱惑
seductive=诱人的
sedulity=勤奋
sedulous=勤奋的
see=看
seed=种子
seedling=幼苗
seek=寻找
seem=似乎
seeming=看似
seemingly=似乎
seemly=得体
seep=渗透
seethe=沸腾
segment=部分
segmental=节段性
segregate=分离
segregation=隔离
seine=罾
seismic=地震
seismograph=地震仪
seismology=地震学
seize=抢占
seizure=发作
seldom=很少
select=选择
selection=选择
selective=选择性
self=自己
self-abasement=自卑
self-absorbed=自我陶醉
self-assertion=自我主张
selfish=自私
selfless=无私
sell=卖
semblance=外表
semester=学期
semi-colon=分号
seminal=精髓
seminar=研讨会
seminary=神学院
senate=参议院
senator=参议员
send=发送
senile=衰老
senior=高级的
seniority=资历
sensation=感觉
sensational=耸人听闻
sense=感觉
sensible=明智的
sensitive=敏感的
sensitivity=敏感度
sensitization=敏感化
sensitize=敏感化
sensor=传感器
sensory=感觉
sensual=感性的
sensuous=感性的
sentence=句子
sententious=格言式的
sentient=有知觉的
sentiment=情绪
sentimental=感伤的
sentinel=哨兵
sentry=哨兵
separate=分离
separation=分离
separatist=分裂分子
september=九月
septic=化粪池
sepulchral=坟墓般的
sequacious=顺从的
sequela=后遗症
sequence=顺序
sequential=顺序的
sequester=隔离
sequestrate=封存
sequoia=红杉
seraphic=天使般的
sere=塞雷
serenade=小夜曲
serendipity=意外发现
serene=安详
serenity=宁静
serfdom=农奴制
sergeant=军士
serial=串行
series=系列
serious=严肃的
sermon=讲道
sermonize=说教
serpentine=蛇纹石
serrate=有锯齿的
serrated=锯齿状
serried=密集
servant=仆人
serve=服务
service=服务
serviceable=可维修
servile=奴性的
serving=服务
servitude=奴役
session=会议
set=放
setback=挫折
setting=环境
settle=定居
settled=已解决
settlement=沉降
seven=七
seventeen=十七
seventy=七十
sever=断绝
several=一些
severe=严重
severity=严重程度
sew=缝
sewage=污水
sewer=下水道
sex=性别
sextant=六分仪
sexual=性
sexy=性感的
shabby=破旧
shack=窝棚
shackle=枷锁
shade=阴凉处
shadow=阴影
shady=阴凉
shaft=轴
shake=摇
shaky=摇摇欲坠
shale=页岩
shall=将
shallow=浅的
sham=假
shamble=摇摇欲坠
shambles=一片混乱
shame=耻辱
shameful=可耻
shameless=不要脸
shanty=棚户区
shape=形状
shard=分片
share=分享
shark=鲨鱼
sharp=锋利的
sharpen=锐化
sharply=急剧
shatter=破碎
shattered=破碎
shave=刮胡子
shaver=剃须刀
shavings=刨花
shawl=披肩
she=她
sheaf=捆
shear=剪切
sheath=鞘
sheathe=包覆
shed=棚
sheen=光泽
sheep=羊
sheer=纯粹
sheet=床单
shelf=架子
shell=壳
shelter=庇护所
shelve=搁置
shepherd=牧羊人
sheriff=警长
shibboleth=口号
shield=盾
shift=转移
shiftiness=狡猾
shiftless=懒惰
shilly-shally=犹豫不决
shimmer=闪光
shine=闪耀
shingle=卵石
shiny=闪亮的
ship=船
shipment=运输
shipping=船运
shipshape=整洁有序
shipwright=造船工
shipyard=船厂
shirk=推脱
shirt=衬衫
shit=拉屎
shiver=颤抖
shoal=浅滩
shock=震惊
shoddy=劣质
shoe=鞋
shoot=射击
shop=店铺
shoplift=商店扒窃
shopping=购物
shopworn=陈旧的
shore=支撑
short=短的
shortage=短缺
shortcoming=缺点
shorthand=速记
shortly=不久
shorts=短裤
shot=射击
should=应该
shoulder=肩膀
shout=喊
shove=推
shovel=铲
show=展示
showcase=展示
shower=淋浴
showy=炫耀
shred=撕碎
shrewd=精明
shriek=尖叫
shrimp=虾
shrine=神社
shrink=收缩
shrivel=萎缩
shroud=裹尸布
shrub=灌木
shrubbery=灌木
shrug=耸肩
shuck=剥壳
shudder=不寒而栗
shuffle=随机播放
shun=避
shunt=分流
shut=关闭
shuttle=穿梭
shy=害羞的
shyly=害羞地
shyness=害羞
sibilant=嘶嘶声
sibling=兄弟
sibyl=女巫
sick=生病的
sicken=生病
side=边
sidereal=恒星
sideshow=杂耍
sidesplitting=令人捧腹大笑
sidestep=回避
sideways=侧身
sidle=侧身
siege=围城
sieve=筛
sift=筛
sigh=叹
sight=视线
sightseeing=观光
sign=符号
signal=信号
signatory=签署人
signature=签名
significance=意义
significant=重要的
significantly=显著地
signify=表示
silence=沉默
silent=沉默的
silica=二氧化硅
silicon=硅
silk=丝绸
silky=丝滑的
sill=窗台
silly=愚蠢的
silt=淤泥
silver=银
silversmith=银匠
silvery=银色的
simian=猿猴
similar=相似的
similarity=相似
simile=明喻
simmer=煨
simonize=西蒙化
simper=傻笑
simple=简单的
simpleton=傻瓜
simplicity=简单
simplify=简化
simply=简单地
simulate=模拟
simulation=模拟
simultaneous=同时
simultaneously=同时地
sin=罪
since=自从
sincere=真诚
sincerity=诚意
sinecure=闲职
sinew=腱子
sing=唱歌
singe=烧焦
singer=歌手
single=单身的
singular=单数
singularity=奇点
sinister=险恶
sink=下沉
sinuous=弯曲的
sip=啜饮
sir=先生
siren=警笛
sister=姐姐
sit=坐
site=地点
sitting=坐
situate=位于
situated=位于
situation=情况
six=六
sixteen=十六
sixty=六十
sizable=相当大的
size=尺寸
sizzler=嘶嘶声
skate=滑冰
skating=溜冰
skein=绞
skeletal=骨骼
skeleton=骨骼
skeptic=怀疑论者
skeptical=持怀疑态度
skepticism=怀疑论
sketch=草图
sketchy=粗略的
skew=歪斜
skewer=串
ski=滑雪
skiff=小艇
skiing=滑雪
skilful=熟练
skill=技能
skilled=熟练
skillet=煎锅
skillful=熟练
skim=撇去
skimp=吝啬
skimpy=吝啬的
skin=皮肤
skinflint=吝啬鬼
skinny=瘦骨嶙峋的
skip=跳过
skirmish=小冲突
skirt=裙子
skit=短剧
skittish=胆怯
skull=颅骨
skullduggery=阴谋
skunk=臭鼬
sky=天空
skyline=天际线
skyrocket=猛涨
skyscraper=摩天大楼
slab=板坯
slack=松弛
slacken=放松
slag=矿渣
slake=熄灭
slam=砰
slander=诽谤
slanderous=诽谤
slant=倾斜
slap=拍击
slapdash=草率
slash=削减
slate=石板
slaughter=屠宰
slave=奴隶
slaver=奴隶贩子
slavery=奴隶制
slay=杀死
sleazy=低俗的
sled=雪橇
sledding=雪橇
sledge=雪橇
sledgehammer=大锤
sleep=睡觉
sleepiness=嗜睡
sleepy=困
sleeve=袖子
sleigh=雪橇
sleight=诡计
slender=苗条
slew=倒转
slice=片
slick=光滑的
slide=滑动
slight=轻微
slightly=轻微地
slim=苗条的
sling=吊索
slink=潜行
slip=滑
slippage=滑移
slipper=拖鞋
slippery=滑
slipshod=马虎
slit=狭缝
slither=滑行
sliver=碎片
slobber=口水
slog=艰苦奋斗
slogan=口号
slope=坡
sloppy=马虎
slosh=晃动
slot=投币口
sloth=懒惰
slouch=伛
slough=泥沼
sloven=斯洛文
slovenly=邋遢的
slow=慢的
slue=斯卢
slug=蛞蝓
sluggard=懒汉
sluggish=迟缓
sluice=水闸
slum=贫民窟
slumber=睡眠
slump=暴跌
slur=诽谤
slurp=啜饮
sly=狡猾
small=小的
smarmy=油腔滑调
smart=聪明的
smartphone=手机
smash=粉碎
smattering=略知一二
smear=涂抹
smell=闻
smelly=臭
smile=微笑
smirch=污点
smirk=傻笑
smite=打击
smog=烟雾
smoggy=烟雾弥漫
smoke=抽烟
smoky=烟
smooth=光滑的
smoothly=顺利
smother=窒息
smudge=弄脏
smug=踌躇满志
smuggle=走私
smuggler=走私者
smuggling=走私
smut=黑穗病
snack=小吃
snag=障碍
snail=蜗牛
snake=蛇
snap=折断
snappish=暴躁
snappy=活泼
snare=圈套
snarl=咆哮
snatch=抢夺
sneak=潜行
sneaking=鬼鬼祟祟
sneer=冷笑
snicker=暗笑
snide=讽刺
sniff=嗅
snip=剪掉
snipe=狙击
snitch=告密者
snivel=鼻涕
snob=势利小人
snobbish=势利
snooze=打盹
snow=雪
snowdrift=雪堆
snowflake=雪花
snowy=下雪
snub=冷落
snug=舒适
snuggle=依偎
so=所以
so-called=所谓的
soak=浸泡
soap=肥皂
soar=翱翔
sob=哭泣
sober=清醒
sobre=索夫雷
sobriety=清醒
soccer=足球
sociable=善于交际
social=社会的
socialise=社交
socialism=社会主义
socialist=社会主义
socialize=社交
society=社会
sociologist=社会学家
sociology=社会学
sock=短袜
socket=插座
sod=草皮
soda=苏打
sodden=烂
sodium=钠
sofa=沙发
soft=柔软的
soften=软化
software=软件
soggy=潮湿的
soigne=苏瓦涅
soil=土壤
sojourn=逗留
solace=慰藉
solar=太阳的
solder=焊接
soldier=士兵
sole=唯一
solely=仅
solemn=庄严
solemnity=严肃
solicit=征求
solicitor=律师
solicitous=殷勤
solicitude=关怀
solid=坚硬的
solidarity=团结
solidify=固化
solidity=坚固性
solidly=坚实地
solitary=孤
solitude=孤独
solo=独奏
soluble=可溶
solution=解决方案
solve=解决
solvent=溶剂
somatic=体细胞
somber=阴沉
some=一些
somebody=某人
somehow=不知何故
someone=某人
something=某物
sometime=有时
sometimes=有时
somewhat=有些
somewhere=某处
somnolent=嗜睡的
son=儿子
sonata=奏鸣曲
song=歌曲
sonnet=十四行诗
sonorous=铿锵有力
soon=很快
soot=煤烟
soothe=抚慰
sop=标准操作规程
sophism=诡辩
sophisticated=复杂的
sophistication=精致
sophistry=诡辩
soporific=催眠
sopping=湿透
soprano=女高音
sorcery=巫术
sordid=龌龊
sore=疮
sorrow=悲哀
sorrowful=悲伤
sorry=对不起
sort=种类
soul=灵魂
soulful=深情的
sound=声音
soup=汤
sour=酸的
source=来源
souse=汤
south=南
southeast=东南
southeastern=东南部
southern=南部
southwest=西南
southwestern=西南地区
souvenir=纪念品
sovereign=主权
sovereignty=主权
sow=母猪
soybean=大豆
space=空间
spacecraft=宇宙飞船
spaceship=飞船
spacious=宽敞
spackle=填缝剂
spade=铲
spaghetti=意大利细面条
span=跨度
spangle=亮片
spank=打屁股
spare=空闲的
sparing=保留
sparingly=谨慎地
spark=火花
sparkle=火花
sparring=陪练
sparse=疏
spartan=斯巴达
spasmodic=痉挛性
spat=口角
spate=大量
spatial=空间
spatter=溅
spatula=抹刀
spawn=产卵
speak=说话
speaker=扬声器
spear=矛
special=特别的
specialisation=专业化
specialise=专业化
specialist=专家
speciality=专业
specialization=专业化
specialize=专业化
specialized=专门
specialty=专业
species=物种
specific=具体的
specifically=具体来说
specification=规格
specifics=具体内容
specify=指定
specimen=标本
specious=似是而非的
speck=斑点
spectacle=奇观
spectacular=壮观
spectator=旁观者
specter=幽灵
spectral=光谱
spectrum=光谱
speculate=推测
speculation=猜测
speculative=投机
speech=演讲
speechless=无言
speed=速度
speeding=超速
speedy=迅速
speleology=洞穴学
spell=拼写
spelling=拼写
spend=花费
spending=开支
spendthrift=败家子
spew=喷出
sphere=领域
spherical=球形
spice=香料
spicy=辛辣的
spider=蜘蛛
spike=长钉
spill=洒
spin=旋转
spinal=脊
spindly=细长的
spine=脊柱
spineless=没有骨气
spinning=纺纱
spiny=多刺的
spiral=螺旋
spire=尖塔
spirit=精神
spiritual=精神
spit=吐
spite=尽管
splash=溅
splashy=溅泼的
spleen=脾
splendid=灿烂
splendor=辉煌
splendour=辉煌
splice=拼接
splint=夹板
split=分裂
splurge=挥霍
spoil=破坏
spoilsport=扫兴
spoke=辐
spokesman=发言人
spokesperson=发言人
spokeswoman=发言人
sponge=海绵
spongy=海绵状
sponsor=赞助
sponsorship=赞助
spontaneity=自发性
spontaneous=自发的
spoof=欺骗
spool=线轴
spoon=勺子
spoonful=一匙
spoor=足迹
sporadic=零星的
sport=运动
sportive=嬉戏的
sportsman=运动员
sportswoman=女运动员
spot=点
spotlight=聚光灯
spouse=配偶
spout=喷口
sprain=扭伤
sprawl=蔓延
sprawling=蔓延
spray=喷
spread=传播
sprig=小枝
sprightly=活泼地
spring=春天
sprinkle=撒
sprint=短跑
sprout=发芽
spruce=云杉
spun=纺纱
spunk=胆量
spur=支线
spurious=虚假的
spurn=唾弃
spurt=喷
spy=间谍
squab=乳鸽
squabble=争吵
squad=队
squalid=骯髒
squall=狂风暴雨
squalor=肮脏
squander=挥霍
square=正方形
squash=壁球
squat=蹲
squeak=吱
squeamish=令人厌恶
squeeze=挤
squelch=静噪
squid=乌贼
squint=眯
squirrel=松鼠
squirt=喷出
stab=刺
stabilise=稳定
stability=稳定
stabilize=稳定
stable=稳定的
staccato=断奏
stack=堆
stadium=体育场
staff=职员
stage=阶段
stagecoach=驿马车
stagger=错开
staggered=交错
staggering=令人震惊
stagnant=停滞
stagnate=凝滞
stagnation=停滞
stagy=做作的
staid=稳重
stain=弄脏
stainless=防锈的
stair=楼梯
staircase=楼梯
stake=赌注
stale=陈旧
stalemate=僵局
stalk=茎
stall=摊位
stalwart=坚定的
stamina=耐力
stammer=结巴
stamp=邮票
stampede=踩踏事件
stance=姿态
stanch=止血
stand=站立
standard=标准
standardisation=标准化
standardise=标准化
standardization=标准化
standardize=标准化
standby=支持
standpoint=立场
standstill=停顿
stanza=节
staple=钉书针
stapler=订书机
star=星星
star-crossed=不幸的
starch=淀粉
starchy=淀粉质
stare=盯
stark=斯塔克
starry=繁星点点
start=开始
starter=起动机
startle=惊吓
startling=令人吃惊
starvation=饥饿
starve=饿死
stash=藏
stasis=停滞
state=状态
stately=庄严
statement=陈述
statesman=政治家
static=静止的
station=车站
stationary=固定的
stationery=静止的
statistic=统计
statistical=统计
statistics=统计数据
statuary=雕像
statue=雕像
stature=身材
status=地位
statute=法令
statutory=法定的
staunch=坚定
stay=停留
steadfast=坚定的
steadily=稳步
steady=稳定的
steak=牛排
steal=偷
stealth=隐身
steam=蒸汽
steamer=汽船
steamy=热气腾腾的
steel=钢
steep=陡
steeple=尖顶
steer=引导
stellar=恒星
stem=干
stench=恶臭
stencil=模版
stentorian=洪亮的
step=步
stereo=立体声
stereotype=刻板印象
sterile=无菌
sterilize=消毒
stern=斯特恩
stethoscope=听诊器
stew=炖
steward=管家
stewardess=空中小姐
stick=戳
stickler=斯蒂克勒
sticky=黏
stiff=僵硬的
stiffen=变硬
stifle=窒息
stigma=柱头
stigmatize=污蔑
still=仍然
stilted=僵硬的
stimulant=兴奋剂
stimulate=刺激
stimulation=刺激
stimulus=刺激
sting=蜇
stinginess=吝啬
stingy=小气
stint=限制
stipple=点画
stipulate=规定
stipulation=規定
stir=搅拌
stitch=缝
stock=库存
stockade=栅栏
stocking=袜
stocky=矮壮
stodgy=沉闷的
stoic=坚忍的
stoke=斯托克
stolid=冷漠的
stomach=胃
stone=石头
stonewall=阻碍
stony=石质的
stool=凳子
stoop=哈腰
stop=停止
stoppage=停工
storage=贮存
store=店铺
storey=层
storm=风暴
stormy=暴风雨的
story=故事
stout=肥硕
stouthearted=坚强的
stove=火炉
stowaway=偷渡者
straggle=落后
straight=直的
straighten=拉直
straightforward=直截了当
strain=拉紧
strait=海峡
straiten=狭窄
strand=股线
stranded=搁浅
strange=奇怪的
stranger=陌生人
strangle=扼杀
strangulation=扼杀
strap=带子
stratagem=诡计
strategic=战略
strategy=战略
stratify=分层
stratum=地层
straw=稻草
stray=流浪
streak=条纹
stream=溪流
streamline=精简
street=街道
strength=力量
strengthen=加强
strenuous=费力的
stress=压力
stressful=有压力的
stretch=拉紧
strew=肸
striate=条纹状
striated=有条纹的
stricken=受傷
strict=严格的
stricture=狭窄
stride=步幅
strident=尖锐的
strife=纷争
strike=罢工
striking=引人注目
string=细绳
stringent=严格
strip=条
stripe=条纹
strive=努力
stroke=中风
stroll=漫步
strong=强的
structural=结构
structure=结构
struggle=斗争
strut=支撑
stubborn=固执的
student=学生
studied=研究过
studio=工作室
study=学习
stuff=东西
stuffing=馅
stuffy=闷
stultify=使愚弄
stumble=绊倒
stump=树桩
stun=眩晕
stunning=令人惊叹的
stunt=特技
stupefy=使昏迷
stupendous=惊人的
stupid=愚蠢的
stupidity=愚蠢
stupor=昏迷
sturdy=结实的
stutter=口吃
stygian=冥河
style=风格
stylish=时髦的
stylistic=文体
stylized=程式化
stylus=触控笔
stymie=阻碍
subdue=征服
subdued=柔和的
subject=主题
subjection=隶属
subjective=主观
subjugate=征服
sublimate=升华
sublime=升华
subliminal=潜意识的
submarine=潜艇
submerge=淹没
submission=提交
submissive=顺从的
submit=提交
subordinate=下属
subordination=从属
suborn=贿赂
subpoena=传票
subscribe=订阅
subscriber=订户
subscription=订阅
subsequent=随后的
subside=塌陷
subsidiary=子公司
subsidise=资助
subsidize=资助
subsidy=补贴
subsist=生存
subsistence=生存
subspecies=亚种
substance=物质
substantial=重大的
substantiate=证实
substantive=实质性
substitute=代替
substitution=替代
substratum=底质
subsume=吸收
subterfuge=托词
subterranean=地下
subtle=微妙的
subtlety=微妙
subtract=减去
subtraction=减法
suburb=市郊
suburban=郊区
subvention=资助
subversive=颠覆性的
subvert=颠覆
subway=地铁
succeed=成功
success=成功
successful=成功的
succession=演替
successive=连续
successor=接班人
succinct=简洁
succor=救助
succumb=屈服
such=这样的
suck=吮吸
sudden=突然
suddenly=突然
sue=起诉
suffer=遭受
suffering=痛苦
suffice=足够
sufficient=充足的
suffocate=窒息
suffrage=选举权
suffragist=妇女参政论者
suffuse=弥漫
sugar=糖
suggest=建议
suggestion=建议
suggestive=暗示性的
suicidal=自杀
suicide=自杀
suit=套装
suitable=合适的
suitcase=手提箱
suite=套房
sulfur=硫
sulky=生气
sullen=忧郁
sully=玷污
sulphur=硫
sultry=闷热
sum=和
summarily=概括地
summarise=总结
summarize=总结
summary=概括
summation=总结
summer=夏天
summit=首脑
summon=召唤
sumptuous=豪华
sun=太阳
sunday=星期日
sunder=破坏
sundry=杂项
sunlight=阳光
sunlit=阳光
sunny=阳光
sunrise=日出
sunset=日落
sunshine=阳光
super=极好的
superannuated=退休
superb=高超
supercilious=傲慢
superficial=浅
superficiality=肤浅
superfluity=多余的
superfluous=多余
superimpose=叠加
superintend=督
superintendent=督察
superior=优越的
superiority=优势
superlative=最高级
supermarket=超级市场
supernova=超新星
supersede=取代
superstition=迷信
superstitious=迷信的
supervise=监督
supervision=监督
supervisor=导师
supine=仰卧
supper=晚餐
supplant=取代
supple=柔韧
supplement=补充
supplementary=补充
suppliant=恳求者
supplicant=恳求者
supplicate=哀告
supplier=供应商
supply=供应
support=支持
supporter=支持者
supportive=支持
suppose=认为
supposedly=据称
supposition=假定
suppress=压制
suppression=抑制
suppressive=抑制
supremacy=霸权
supreme=最高
surcharge=附加费
sure=当然
surf=冲浪
surface=表面
surfeit=过量
surfing=冲浪
surge=涌
surgeon=外科医生
surgery=外科手术
surgical=外科
surly=粗暴
surmise=推测
surmount=超越
surname=姓
surpass=超过
surplus=剩余
surprise=惊喜
surrealism=超现实主义
surrender=投降
surreptitious=偷偷摸摸的
surrogate=代孕
surround=环绕
surroundings=周围环境
surveillance=监视
survey=民意调查
surveyor=测量员
survival=生存
survive=存活
survivor=幸存者
susceptibility=易感性
susceptible=易受影响的
suspect=怀疑
suspend=暂停
suspense=悬念
suspension=暂停
suspicion=怀疑
suspicious=可疑的
sustain=维持
sustainability=可持续性
sustainable=可持续的
sustained=持续
sustenance=生计
suture=缝合
svelte=苗条
swagger=昂首阔步
swallow=吞
swamp=沼泽
swan=天鹅
swank=斯旺克
swap=交换
swarm=群
swarthy=黑黝黝的
swathe=绑扎
sway=摇摆
swear=发誓
sweat=汗
sweater=毛衣
sweep=扫
sweeping=扫荡
sweet=甜的
swell=膨胀
sweltering=闷热
swerve=转向
swift=迅速
swig=痛饮
swill=泔水
swim=游泳
swimmer=游泳者
swimming=游泳
swindle=骗取
swine=猪
swing=摇摆
swipe=滑动
swirl=漩涡
switch=转变
swoop=猛扑
sword=剑
sybarite=享乐主义者
sybaritic=享乐主义
sycophant=谄媚者
syllable=音节
syllabus=教学大纲
symbiosis=共生
symbol=象征
symbolic=象征性的
symbolical=象征性的
symmetric=对称
symmetrical=对称
symmetry=对称
sympathetic=同情的
sympathise=同情
sympathize=同情
sympathy=同情
symphony=交响乐
symposium=座谈会
symptom=症状
synchronize=同步
synchronous=同步
syndicate=辛迪加
syndrome=综合症
synergic=协同的
synonym=代名词
synopsis=概要
synoptic=概要
synthesis=合成
synthesise=合成
synthesize=合成
synthetic=合成的
syringe=注射器
syrup=糖浆
system=系统
systematic=系统的
systematically=系统地
table=桌子
tablet=药片
taboo=忌讳
tacit=默契
taciturn=沉默寡言
tack=钉
tackiness=粘性
tackle=处理
tact=机智
tactful=圆滑的
tactic=策略
tactics=策略
tactile=触
tadpole=蝌蚪
tag=标签
tail=尾巴
tailor=裁缝
take=拿
takeoff=起飞
taking=服用
tale=故事
talent=天赋
talented=有才华的
talisman=护符
talk=讲话
talkative=健谈
tall=高的
tally=相符
talon=爪
tambourine=铃鼓
tame=驯服
tamp=夯
tamper=篡改
tan=棕褐色
tangential=切向的
tangible=有形
tangle=纠纷
tango=探戈
tangy=浓烈的
tank=坦克
tanker=油船
tantalize=吊胃口
tantamount=相当于
tantrum=发脾气
tap=轻敲
tape=磁带
taper=锥度
tapestry=挂毯
tardy=迟迟
tare=皮重
target=目标
tariff=关税
tarnish=玷污
tarpaulin=篷布
tarry=逗留
tart=酸
task=任务
taste=品尝
tasty=可口
tatter=破布
tattered=破烂
tattle=告密
tatty=破旧的
taunt=嘲讽
taut=绷紧
tauten=拉紧
tautological=同义反复
tawdry=俗气的
tax=税
taxation=税收
taxi=出租车
taxing=征税
taxonomist=分类学家
tea=茶
teach=教
teacher=老师
teaching=教学
team=团队
tear=撕
tease=逗
tech=技术
technical=技术的
technician=技术员
technique=技术
technocrat=技术官僚
technological=技术
technology=技术
tectonics=构造学
tedious=乏味
tedium=乏味
teem=蒂姆
teen=青少年
teenager=青少年
teeter=摇摇晃晃
teetotal=戒酒
telecommunications=电信
telegraph=电报
telephone=电话
telescope=望远镜
telescopic=伸缩式
television=电视
tell=告诉
teller=出纳员
telling=告诉
temerity=鲁莽
temp=温度
temper=脾气
temperament=气质
temperance=节制
temperate=温和的
temperature=温度
tempest=暴风雨
tempestuous=暴风雨般的
temple=寺庙
tempo=速度
temporal=颞
temporarily=暂时地
temporary=暂时的
temporize=拖延
tempt=诱惑
temptation=诱惑
ten=十
tenable=站得住脚
tenacious=顽强
tenacity=韧性
tenant=租户
tend=趋向
tendency=趋势
tendentious=倾向性的
tender=投标
tendinous=腱状的
tendon=肌腱
tenement=物业
tenet=宗旨
tennis=网球
tenor=男高音
tense=紧张
tensile=拉伸
tension=紧张
tent=帐篷
tentacle=触手
tentative=暂定的
tenuous=脆弱的
tenure=任期
tepid=不温不火
term=学期
terminal=终端
terminate=终止
termination=终止
terminology=术语
terminus=终点站
termite=白蚁
terrace=阳台
terrain=地形
terrestrial=陆地
terrible=糟糕的
terribly=可怕
terrific=了不起
terrify=恐吓
territorial=领土
territory=领土
terror=恐怖
terrorism=恐怖主义
terrorist=恐怖分子
terse=简洁
tertiary=第三
test=测试
testament=遗嘱
testator=立遗嘱人
testify=作证
testimony=见证
testiness=易怒
testy=暴躁的
tether=系绳
text=文本
textbook=教科书
textile=纺织品
texture=质地
than=比
thank=感谢
thankful=感激
thanksgiving=感恩
that=那
thatch=苫
thaw=解冻
the=这
theater=剧院
theatre=剧院
theatrical=戏剧
theft=盗窃
their=他们的
theirs=他们的
them=他们
thematic=主题
theme=主题
themselves=他们自己
then=然后
theocracy=神权政治
theoretical=理论
theory=理论
therapeutic=治疗
therapeutical=治疗
therapist=治疗师
therapy=治疗
there=那里
thereby=从而
therefore=所以
thermal=热的
thermometer=温度计
these=这些
thesis=论文
thespian=戏剧性的
they=他们
thick=厚的
thicket=灌木丛
thief=贼
thigh=大腿
thin=薄的
thing=事物
think=思考
thinking=思维
third=第三
thirst=口渴
thirsty=渴
thirteen=十三
thirty=三十
this=这
thorn=刺
thorny=棘手的
thorough=彻底
those=那些
though=尽管
thought=想法
thoughtful=周到
thousand=千
thrall=奴役
thrash=痛击
thread=线
threadbare=破旧的
threat=威胁
threaten=威胁
three=三
thresh=脱粒
threshold=临界点
thrift=节约
thrifty=节俭
thrill=刺激
thriller=惊悚
thrive=蓬勃发展
throat=喉
throes=阵痛
throne=王座
throng=人群
throttle=风门
through=通过
throughout=自始至终
throw=扔
throwback=复古
thrust=推力
thumb=拇指
thump=扑通
thunder=雷
thunderous=雷鸣般的
thursday=周四
thus=因此
thwart=阻挠
tick=打钩
ticket=票
tickle=痒痒
tickler=挠痒痒
ticklish=怕痒
tidal=潮汐
tide=潮
tidy=整齐的
tie=领带
tiff=蒂芙
tiger=老虎
tight=紧的
tighten=收紧
tightfisted=吝啬的
tigress=母老虎
tile=瓦
till=直到
tilt=倾斜
tilted=斜
timber=木材
timbre=音色
time=时间
timely=及时
timeworn=陈旧的
timid=胆小
timidity=胆怯
timing=定时
timorous=胆怯的
tin=锡
tinder=火种
tined=尖头的
tinge=色调
tingle=刺痛
tinker=修补
tint=着色
tiny=微小的
tip=提示
tipple=喝
tirade=长篇大论
tire=胎
tired=疲劳的
tireless=不知疲倦
tiresome=令人厌烦
tiring=累人
tissue=组织
titanic=泰坦尼克号
title=标题
titular=名义
to=到
toady=拍马屁
toast=吐司
tobacco=烟草
today=今天
toe=脚趾
together=一起
toil=辛劳
toilet=洗手间
token=令牌
tolerable=可以忍受
tolerance=宽容
tolerant=宽容
tolerate=容忍
toll=收费
tomato=番茄
tombstone=墓碑
tomorrow=明天
ton=吨
tone=语气
tongs=钳
tongue=舌头
tonic=补品
tonight=今晚
tonnage=吨位
tonsorial=理发师
tony=托尼
too=也
tool=工具
tooth=齿
top=顶部
topic=话题
topical=专题
topography=地形
topple=推翻
topsoil=表土
topsy-turvy=颠倒
torch=火炬
torment=折磨
tornado=龙卷风
torpedo=鱼雷
torpid=迟钝
torpor=麻木
torque=扭矩
torrent=激流
torrential=滂沱
torrid=热带
torso=躯干
tortuous=曲折
torture=酷刑
torturous=折磨人的
toss=折腾
total=全部的
totalitarian=极权主义
totem=图腾
totter=蹒跚
touch=触碰
touching=接触
touchstone=试金石
touchy=敏感的
tough=艰难的
toupee=假发
tour=旅游
tourism=旅游
tourist=游客
tournament=比赛
tourniquet=止血带
tousle=凌乱
tout=吹捧
tow=拖
toward=朝向
towards=向
towel=毛巾
tower=塔
towering=参天
town=镇
township=乡
toxic=有毒的
toxin=毒素
toy=玩具
trace=痕迹
traceable=可追溯
track=追踪
tract=道
tractability=易处理性
tractable=易处理
tractor=拖拉机
trade=贸易
trademark=商标
tradition=传统
traditional=传统的
traduce=谮
traffic=交通
trafficking=贩运
tragedy=悲剧
tragic=悲惨
tragically=悲惨地
trail=踪迹
trailer=拖车
train=火车
trainee=学员
trainer=培训师
training=训练
traipse=拖曳
trait=特征
traitor=叛徒
trajectory=弹道
tram=电车
trammel=束缚
tramp=流浪汉
trample=践踏
trance=发呆
tranquil=宁静
tranquility=宁静
transact=办理
transaction=交易
transcend=超越
transcendent=超然的
transcendental=超然的
transcribe=录制
transcript=成绩单
transfer=转移
transference=移情
transfigure=变身
transfix=刺穿
transform=转换
transformation=转型
transfuse=输血
transgress=违反
transgression=违法
transience=短暂性
transient=瞬态
transistor=晶体管
transit=过境
transition=过渡
transitional=过渡的
transitory=暂时的
translate=翻译
translation=翻译
translator=翻译
translucent=半透明
transmission=传播
transmit=发送
transmitter=发射机
transmute=转化
transparency=透明度
transparent=透明的
transpire=发散
transplant=移植
transplantation=移植
transport=运输
transportation=运输
transpose=转置
trap=陷阱
trapeze=空中飞人
trash=垃圾
trauma=创伤
traumatic=创伤性
travel=旅行
traverse=横穿
travesty=讽刺
trawl=拖网
tray=托盘
treacherous=奸诈
treachery=背信弃义
tread=踏
treason=叛国罪
treasure=宝藏
treasurer=财务主管
treasury=财政部
treat=对待
treatise=论文
treatment=治疗
treaty=条约
tree=树
trek=跋涉
tremble=颤抖
tremendous=巨大的
tremor=震颤
tremulous=颤抖的
trench=沟
trenchant=尖刻的
trend=趋势
trepidation=惶恐
trespass=侵入
tresses=发辫
trial=审判
triangle=三角形
triangular=三角形
tribal=部落
tribe=部落
tribulation=苦难
tribunal=法庭
tribune=论坛
tributary=支流
tribute=贡
trick=诡计
trickery=诡计
trickle=涓涓细流
tricky=棘手的
trident=三叉戟
trifle=琐事
trifling=微不足道
trigger=扳机
trillion=兆
trilogy=三部曲
trim=修剪
trinket=小饰品
trio=三重奏
trip=旅行
triple=三倍
tripod=三脚架
trite=陈词滥调
triumph=胜利
triumphant=凯
trivia=琐事
trivial=琐碎的
troll=巨魔
trolley=手推车
troop=部队
trophy=杯
tropic=热带
tropical=热带
trot=小跑
trouble=麻烦
troublesome=麻烦的
trounce=击败
troupe=剧团
trousers=裤子
trowel=镘
truancy=逃学
truant=逃学
truce=休战
truck=卡车
truculent=好斗的
trudge=跋涉
TRUE=TRUE
truism=真理
truly=确实
trumpery=虚假的东西
trumpet=喇叭
truncate=截短
trunk=树干
truss=桁架
trust=相信
trustee=受托人
trustworthy=值得信赖
truth=真相
truthful=真实
try=尝试
trying=尝试
tub=浴缸
tube=管子
tuber=块茎
tuck=塔克
tuesday=周二
tug=拖船
tuition=学费
tumble=翻滚
tumid=肿胀的
tumor=瘤
tumour=瘤
tumult=骚乱
tundra=苔原
tune=调
tunnel=隧道
turbulence=湍流
turbulent=湍流
tureen=汤碗
turgid=浮肿的
turkey=火鸡
turmoil=动荡
turn=转动
turncoat=叛徒
turnout=结果发现
turnover=周转
turnpike=收费公路
turpitude=卑鄙
turquoise=绿松石
turret=炮塔
turtle=龟
tusk=象牙
tussle=争斗
tutelage=监护
tutor=导师
tutorial=教程
tuxedo=燕尾服
tv=电视
twaddle=废话
tweak=调整
twelfth=第十二
twelve=十二
twentieth=第二十
twenty=二十
twice=两次
twig=枝条
twin=双
twine=缠绕
twinge=刺痛
twinkling=闪烁
twist=捻
two=二
tycoon=巨头
type=类型
typewriter=打字机
typhoon=台风
typical=典型的
typist=打字员
typo=拼写错误
typographical=印刷术
tyranny=暴政
tyrant=暴君
tyre=胎
tyro=初学者
ubiquitous=无处不在
ugliness=丑陋
ugly=丑陋的
ulcer=溃疡
ulcerate=溃疡
ulterior=别有用心
ultimate=最终的
ultimately=最终
ultimatum=最后通牒
ultra=极端主义者
ultramundane=超凡脱俗
ultraviolet=紫外线
umbrage=愤怒
umbrella=伞
umpire=裁判
unaffected=不受影响
unaided=无人帮助
unanimity=一致同意
unanimous=一致
unassuming=谦逊
unbecoming=不雅
unbend=伸直
unbiased=不偏不倚
unbidden=未经邀请
unblemished=完美无瑕
unbosom=吐露心声
unbridled=肆无忌惮
uncanny=不可思议的
uncertain=不确定
uncertainty=不确定
uncle=叔叔
uncommitted=未承诺
unconscionable=不合情理
unconscious=无意识
unconsolidated=未固结
unconventional=非常规
uncooperative=不合作
uncouth=粗野
uncover=揭露
unctuous=油腔滑调的
undaunted=无所畏惧
under=在下面
underbid=出价过低
undercut=底切
underdeveloped=欠发达
underdog=失败者
underestimate=低估
underestimated=低估
undergird=支撑
undergo=经历
undergraduate=本科
underground=地下
underhanded=暗中
underlie=基础
underline=强调
underling=下属
underlying=潜在的
undermine=破坏
underneath=下
underplay=轻描淡写
underrate=低估
underscore=下划线
understand=理解
understanding=理解
understate=轻描淡写
understated=低调
understatement=轻描淡写
understudy=替补
undertake=承担
undertaking=承诺
underutilized=未充分利用
underwear=内衣
underwrite=包销
undeserved=不值得
undesirable=不受欢迎的
undirected=无指向的
undisputable=无可争辩
undo=撤消
undoubtedly=无疑
undulate=波动
unearth=挖掘
unearthly=超凡脱俗
uneasy=不安
unemployed=失业
unemployment=失业
unenlightened=闭塞
uneven=不均匀
unexceptionable=无可非议
unexceptional=平凡的
unfailing=永不失败
unfair=不公平
unfasten=解开
unfeigned=慥
unflappable=镇定自若
unfold=展开
unfortunately=很遗憾
unfounded=毫无根据
ungainly=笨拙地
ungrudging=不情愿
unguent=软膏
unicorn=独角兽
unidimensional=单维的
unification=统一
uniform=制服
uniformity=均匀性
unify=统一
unilateral=单方面
unimpassioned=冷漠的
unimpeachable=无可指责
uninitiated=未入门
union=联盟
unique=独特的
unison=齐奏
unit=单元
unite=团结
unity=统一
universal=普遍的
universe=宇宙
university=大学
univocal=单义的
unjustified=不合理的
unjustly=不公正地
unkempt=蓬头垢面
unleash=发挥
unless=除非
unmitigated=未减轻
unmoved=无动于衷
unnoticed=未被注意到
unobtrusive=不引人注目
unpalatable=难吃
unparalleled=无与伦比
unprecedented=空前的
unpredictable=不可预测
unpremeditated=未经预谋的
unprepossessing=不讨人喜欢的
unpretentious=朴实无华
unprincipled=无原则的
unproductive=不具生产力
unprovoked=无缘无故
unqualified=不合格
unravel=绎
unregenerate=未重生的
unregulated=不受监管
unremitting=不懈
unrepentant=不悔改
unrequited=单相思
unreserved=毫无保留
unruly=不羁
unscathed=毫发无损
unscented=无香味
unscrupulous=肆无忌惮
unscrupulousness[ʌn'skru:pjuləsnis]=肆无忌惮[ʌn'skru:pjuləsnis]
unseemly=不雅
unsettle=不安
unsettling=令人不安
unshaken=坚定不移
unsound=不健全
unspoiled=未受污染
unspotted=无斑点
unstinting=不吝惜
unsubstantiated=未经证实
untamed=未驯服的
untapped=尚未开发
unthreatening=不具威胁性
until=直到
untimely=不合时宜
untold=未曾讲述
untoward=不愉快的
untrammeled=奔放
untutored=未受过指导
unveil=揭开
unwarranted=毫无根据
unwieldy=笨重
unwitting=不知情
unwonted=不寻常的
unworldly=不世俗的
up=向上
up-to-date=最新
upbraid=吒
update=更新
upfront=预付
upgrade=升级
upheaval=动荡
uphold=坚持
upload=上传
upon=之上
upper=上
uppermost=最上层
upright=直立
uprising=起义
uproar=骚动
uproarious=哄然
upset=沮丧的
upstage=抢占风头
upstairs=楼上
upstart=暴发户
upsurge=高涨
upswing=上升
uptight=紧张
upward=向上
upwards=向上
uranium=铀
urban=城市的
urbanisation=城市化
urbanise=城市化
urbanization=城市化
urbanize=城市化
urchin=顽童
urge=敦促
urgency=紧迫性
urgent=紧迫的
urinate=排尿
urine=尿
ursine=熊
us=我们
usage=用法
use=使用
used=用过的
useful=有用
useless=无用
user=用户
usual=通常
usually=通常
usurp=篡
usury=高利贷
utensil=用具
utilisation=利用率
utilise=利用
utilitarian=功利主义
utility=公用事业
utilization=利用率
utilize=利用
utmost=尽最大努力
utopia=乌托邦
utopian=乌托邦
utter=说出
utterly=完全
uxorious=妻子的
v.=五、
vacancy=空缺
vacant=空缺
vacate=撤离
vacation=假期
vaccinate=接种疫苗
vaccination=接种疫苗
vaccine=疫苗
vacillate=动摇
vacuous=空虚的
vacuum=真空
vagabond=流浪汉
vagary=奇想
vagrancy=流浪
vagrant=流浪汉
vague=模糊的
vain=徒劳的
valediction=告别辞
valedictory=告别辞
valetudinarian=体弱多病的人
valiant=英勇
valid=有效的
validate=证实
validity=有效性
valley=谷
valor=勇气
valorous=英勇
valuable=有价值的
value=价值
valve=阀门
vampire=吸血鬼
van=货车
vandalism=故意破坏
vandalize=破坏
vanguard=先锋
vanilla=香草
vanish=消失
vanity=虚荣
vanquish=征服
vantage=有利位置
vapid=乏味的
vapor=汽
vaporization=汽化
vaporize=蒸发
vaporous=蒸气
vapour=汽
variable=多变的
variance=方差
variant=变体
variation=变化
varied=多种多样
variegate=斓
variegation=斑驳
variety=种类
various=各种各样的
varnish=漆
vary=各不相同
vascular=血管
vast=广阔的
vault=保险库
vaunting=自夸
veer=转向
vegetable=蔬菜
vegetarian=素食
vegetate=植物生长
vegetation=植被
vehemence=激烈
vehement=慷慨
vehicle=车辆
veil=面纱
vein=静脉
velocity=速度
velvet=天鹅绒
velvety=天鹅绒般的
venal=贪污
vendetta=仇杀
vendor=小贩
veneer=单板
venerate=崇敬
vengeance=复仇
vengeful=复仇心切
venial=轻微的
venom=毒液
vent=发泄
ventilate=通风
ventilation=通风
ventral=腹侧
ventriloquist=腹语者
venture=风险投资
venue=场地
veracious=诚实的
veracity=真实性
verb=动词
verbal=口头
verbatim=逐字
verbiage=措辞
verbose=冗长
verboten=禁止
verdant=葱茏
verdict=判决
verdigris=铜绿
verge=边缘
verification=确认
verified=已验证
verify=核实
verisimilar=逼真
verisimilitude=逼真
veritable=名副其实
vermin=害虫
vernacular=白话
vernal=春天的
versant=韦尔桑特
versatile=多才多艺的
verse=诗
versemonger=诗歌贩子
version=版本
versus=相对
vertebrate=脊椎动物
vertex=顶点
vertical=垂直的
vertigo=眩晕
verve=气魄
very=非常
vessel=血管
vest=背心
vestige=痕迹
vestigial=残留的
vestment=法衣
vesture=笼罩
veteran=老将
veterinary=兽医
veto=否决
vex=烦恼
vexation=烦恼
via=通过
viability=生存力
viable=维亚
viaduct=高架桥
viand=维安德
vibrancy=活力
vibrant=充满活力
vibrate=颤动
vibration=振动
vicar=牧师
vicarious=替代的
vice=副
vicinity=附近
vicious=恶毒
vicissitude=变迁
vicissitudinous=沧桑
victim=受害者
victimize=使受害
victorious=胜利的
victory=胜利
video=视频
vie=争夺
view=看法
viewpoint=观点
vigilant=警惕的
vigor=活力
vigorous=蓬勃
vile=卑鄙
vilify=丑化
village=村庄
villager=村民
villainous=邪恶的
vim=vim
vindicate=表白
vindication=辩护
vindictive=报复心强
vinegar=醋
vinegared=醋
vintage=优质的
vintner=酿酒师
violate=违反
violation=违反
violence=暴力
violent=暴力
violently=猛烈地
violet=紫色
violin=小提琴
violinist=小提琴手
virago=泼妇
viral=病毒性的
virgin=处女
virginity=童贞
virile=阳刚之气
virtual=虚拟的
virtually=几乎
virtue=美德
virtuosity=技艺精湛
virtuoso=演奏家
virtuous=有德行
virulent=毒性
virus=病毒
visa=签证
visage=面容
visceral=内脏
viscid=粘稠的
viscous=粘稠的
visibility=能见度
visible=可见的
vision=想象
visionary=有远见的
visit=访问
visitor=游客
vista=维斯塔
visual=视觉的
visualise=可视化
visualize=可视化
vital=必不可少的
vitality=活力
vitalize=使活跃
vitamin=维他命
vitiate=变质
vitreous=玻璃
vitrify=玻璃化
vitriolic=硫酸
vituperate=谩骂
vituperative=辱骂性的
vivacious=活泼
vivid=生动
vocabulary=词汇
vocal=声音
vocalist=歌手
vocation=职业
vocational=职业
vogue=时尚
voice=嗓音
void=空白
volatile=易挥发的
volatility=挥发性
volcanic=火山
volcano=火山
volition=意志
volley=截击
volleyball=排球
volt=伏特
voltage=电压
voluble=滔滔不绝
volume=体积
voluminous=庞大的
voluntary=自愿
volunteer=志愿者
voluptuous=丰满的
vomit=呕吐
voracious=贪婪的
voracity=贪婪
votary=信徒
vote=投票
voter=选民
vouch=担保
voucher=代金券
vow=发誓
voyage=航程
vulgar=庸俗
vulgarity=粗俗
vulnerability=脆弱性
vulnerable=易受伤害的
vulpine=狐狸
vulture=秃鹫
vying=争夺
wacky=古怪的
waddle=蹒跚而行
wade=韦德
waffle=胡扯
waft=飘荡
wag=摇摆
wage=工资
waggish=诙谐的
waggon=车皮
wagon=车皮
wail=哀号
waist=腰部
wait=等待
waiter=服务员
waitress=女服务员
waive=放弃
waiver=放弃
wake=唤醒
waken=唤醒
walk=走
wall=墙
wallet=钱包
wallop=瓦洛普
wallow=泥坑
walrus=海象
wan=萬
wand=魔杖
wander=漫步
wanderlust=旅行癖
wane=衰落
wangle=王尔德
want=想
wanton=放肆
war=战争
warble=颤声
ward=病房
warden=监狱长
wardrobe=衣柜
ware=器皿
warehouse=仓库
warfare=战争
warily=小心地
warm=温暖的
warmonger=战争贩子
warmth=温暖
warn=警告
warning=警告
warp=经
warrant=保证
warranted=有理由
warranty=保修单
warrior=战士
wary=警惕
wash=洗
washing=洗涤
wasp=黄蜂
waspish=尖刻的
waste=浪费
wasteful=浪费
wastrel=败家子
watch=手表
watchful=警惕的
water=水
watercourse=河道
waterproof=防水的
watershed=分水岭
watertight=防水
watt=瓦
wave=海浪
waver=动摇
wavy=波浪形
wax=蜡
way=方式
waylay=伏击
we=我们
weak=虚弱的
weaken=削弱
weakness=弱点
wealth=财富
wealthy=富裕
wean=断奶
weapon=武器
wear=穿
weariness=疲劳
wearisome=令人厌烦
weary=厌倦
weasel=黄鼠狼
weather=天气
weathering=风化
weave=编织
web=网络
webcast=网络广播
website=网站
wed=结婚
wedding=婚礼
wedge=楔
wednesday=周三
weed=杂草
week=星期
weekday=平日
weekend=周末
weekly=每周
weep=哭泣
weigh=称重
weight=重量
weird=诡异的
welcome=欢迎
weld=焊接
welfare=福利
well=出色地
well-being=福利
well-groomed=精心打扮
well-known=知名
well-off=富裕
welsh=威尔士语
welter=混乱
wend=温德
west=西方
western=西
westerner=西方人
wet=湿的
whale=鲸
wharf=码头
what=什么
whatever=任何
whatsoever=任何
wheat=小麦
wheedle=哄骗
wheel=车轮
wheeze=喘息
whelm=掌舵
whelp=仔
when=什么时候
whenever=每当
where=在哪里
whereabouts=下落
whereas=然而
whereby=由此
wherever=无论
whet=磨砺
whether=无论
which=哪个
whichever=任何
whiff=嗅闻
while=尽管
whilst=同时
whim=心血来潮
whimper=呜咽
whimsical=异想天开
whimsy=奇思妙想
whine=抱怨
whip=鞭
whir=呼呼
whirl=旋转
whirlpool=漩涡
whisky=威士忌酒
whisper=耳语
whistle=哨
whit=白衣
white=白色的
whittle=削减
who=WHO
whoever=谁
whole=所有的
wholesale=批发的
wholesome=健康
wholly=完全
whom=谁
whose=谁
why=为什么
wick=灯芯
wicked=邪恶
wide=宽的
widen=扩大
widespread=广泛
widow=寡妇
widower=鳏夫
width=宽度
wield=挥
wife=妻子
wig=假发
wiggle=摆动
wigwag=摇
wild=荒野
wilderness=荒野
wildlife=野生动物
wile=诡计
will=将要
willful=任性
willing=愿意的
willingness=意愿
willow=柳
willowy=有弹性
willpower=意志
willy-nilly=不管愿意不愿意
wilt=枯萎
wily=狡猾的
win=赢
wince=胜利
wind=风
windbag=空谈者
windfall=意外之财
winding=绕线
window=窗户
windy=有风
wine=葡萄酒
winery=酒厂
wing=翼
wink=眨眼
winkle=温克尔
winner=优胜者
winning=获胜
winnow=簸
winsome=迷人
winter=冬天
wipe=擦拭
wire=金属丝
wireless=无线的
wiretap=窃听
wisdom=智慧
wise=明智的
wish=希望
wispy=纤细的
wistful=渴望的
wit=智慧
witch=巫婆
with=和
withdraw=提取
withdrawal=退出
wither=枯萎
withhold=扣压
within=之内
without=没有
withstand=经受
witness=证人
witticism=妙语
witty=机智
wizardry=巫术
wizen=干瘪
wizened=干瘪
wobble=摇晃
woe=祸患
wolf=狼
woman=女士
wonder=想知道
wonderful=精彩的
wont=惯于
woo=呼唤
wood=木头
woodcut=木刻版画
wooden=木制的
wool=羊毛
woolen=羊毛
woollen=羊毛
word=单词
wording=措辞
work=工作
worker=工人
workforce=劳动力
workout=锻炼
workshop=车间
world=世界
worldly=世俗
worldwide=全世界
worm=蠕虫
worried=担心
worry=担心
worse=更糟
worship=崇拜
worst=最差
worth=值得
worthiness=价值
worthless=毫无价值
worthwhile=值得
worthy=值得
would=会
wound=伤口
wraith=幽灵
wrangle=争吵
wrangler=牧马人
wrap=裹
wrapping=包装
wrath=愤怒
wreak=造成
wreathe=盘绕
wreck=破坏
wreckage=残骸
wrench=扳手
wrest=夺取
wrestle=搏斗
wrestling=摔角
wretched=可怜
wring=拧
wrinkle=皱纹
wrist=手腕
writ=令状
write=写
writer=作家
writing=写作
wrong=错误的
wroth=愤怒
wrought=锻
wry=讽刺
x-ray=射线
xenophobe=排外主义者
xenophobia=仇外心理
xerophyte=旱生植物
yacht=游艇
yank=猛拉
yard=院子
yarn=纱
yaw=偏航
yawn=打哈欠
yeah=是的
year=年
yearly=每年
yearn=向往
yearning=向往
yeast=酵母
yell=叫喊
yellow=黄色的
yelp=喊叫
yen=日元
yeoman=农夫
yes=是的
yesterday=昨天
yet=然而
yield=屈服
yielding=屈服
yoga=瑜伽
yoghurt=酸奶
yogurt=酸奶
yoke=轭
yokel=乡巴佬
you=你
young=年轻的
youngster=青少年
your=你的
yours=你的
yourself=你自己
yourselves=你们自己
youth=青年
youthful=年轻的
yowl=号叫
yummy=好吃
zany=滑稽的
zeal=热情
zealotry=狂热
zealous=热心
zenith=天顶
zephyr=和风
zero=零
zest=热情
zesty=有活力的
zigzag=之字形
zinc=锌
zip=拉链
zipper=拉链
zone=区
zoo=动物园
zoological=动物学
zoology=动物学
zoom=飞涨
pores=毛孔
strawberry=草莓
was=是
